cqs_suffix|nasdaq_suffix
A|A
AA|AA
AAA|AAA
AAAU|AAAU
AAC|AAC
AAC.U|AAC=
AAC.WS|AAC+
AAIC|AAIC
AAICpB|AAIC-B
AAICpC|AAIC-C
AAIN|AAIN
AAMpA|AAM-A
AAMpB|AAM-B
AAMC|AAMC
AAN|AAN
AAP|AAP
AAQC|AAQC
AAQC.U|AAQC=
AAT|AAT
AAU|AAU
AB|AB
ABB|ABB
ABBV|ABBV
ABC|ABC
ABEQ|ABEQ
ABEV|ABEV
ABG|ABG
ABM|ABM
ABR|ABR
ABRpD|ABR-D
ABRpE|ABR-E
ABRpF|ABR-F
ABT|ABT
AC|AC
ACA|ACA
ACAQ|ACAQ
ACAQ.U|ACAQ=
ACAQ.WS|ACAQ+
ACCO|ACCO
ACDI|ACDI
ACDI.U|ACDI=
ACDI.WS|ACDI+
ACEL|ACEL
ACES|ACES
ACHR|ACHR
ACHR.WS|ACHR+
ACI|ACI
ACIO|ACIO
ACM|ACM
ACN|ACN
ACP|ACP
ACPpA|ACP-A
ACR|ACR
ACRpC|ACR-C
ACRpD|ACR-D
ACRE|ACRE
ACRO|ACRO
ACRO.U|ACRO=
ACRO.WS|ACRO+
ACSI|ACSI
ACTV|ACTV
ACU|ACU
ACV|ACV
ACVF|ACVF
ACWF|ACWF
ACWV|ACWV
ADC|ADC
ADCpA|ADC-A
ADCT|ADCT
ADEX|ADEX
ADEX.U|ADEX=
ADEX.WS|ADEX+
ADFI|ADFI
ADIV|ADIV
ADM|ADM
ADME|ADME
ADNT|ADNT
ADPV|ADPV
ADRA|ADRA
ADRA.U|ADRA=
ADRA.WS|ADRA+
ADRT|ADRT
ADRT.U|ADRT=
ADT|ADT
ADX|ADX
AE|AE
AEE|AEE
AEF|AEF
AEFC|AEFC
AEG|AEG
AEL|AEL
AELpA|AEL-A
AELpB|AEL-B
AEM|AEM
AEMB|AEMB
AENZ|AENZ
AEO|AEO
AER|AER
AES|AES
AESC|AESC
AESR|AESR
AEVA|AEVA
AEVA.WS|AEVA+
AFB|AFB
AFG|AFG
AFGB|AFGB
AFGC|AFGC
AFGD|AFGD
AFGE|AFGE
AFIF|AFIF
AFK|AFK
AFL|AFL
AFLG|AFLG
AFMC|AFMC
AFSM|AFSM
AFT|AFT
AFTR|AFTR
AFTR.U|AFTR=
AFTR.WS|AFTR+
AFTY|AFTY
AG|AG
AGAC|AGAC
AGAC.U|AGAC=
AGAC.WS|AGAC+
AGCB|AGCB
AGCO|AGCO
AGD|AGD
AGE|AGE
AGG|AGG
AGGH|AGGH
AGGY|AGGY
AGI|AGI
AGIH|AGIH
AGL|AGL
AGM|AGM
AGMpC|AGM-C
AGMpD|AGM-D
AGMpE|AGM-E
AGMpF|AGM-F
AGMpG|AGM-G
AGM.A|AGM.A
AGO|AGO
AGOV|AGOV
AGOX|AGOX
AGQ|AGQ
AGR|AGR
AGRH|AGRH
AGRO|AGRO
AGS|AGS
AGTI|AGTI
AGX|AGX
AGZ|AGZ
AHH|AHH
AHHpA|AHH-A
AHHX|AHHX
AHLpC|AHL-C
AHLpD|AHL-D
AHLpE|AHL-E
AHOY|AHOY
AHT|AHT
AHTpD|AHT-D
AHTpF|AHT-F
AHTpG|AHT-G
AHTpH|AHT-H
AHTpI|AHT-I
AHYB|AHYB
AI|AI
AIC|AIC
AIEQ|AIEQ
AIF|AIF
AIG|AIG
AIGpA|AIG-A
AILG|AILG
AILV|AILV
AIM|AIM
AIN|AIN
AINC|AINC
AIO|AIO
AIR|AIR
AIRC|AIRC
AIRI|AIRI
AIT|AIT
AIU|AIU
AIV|AIV
AIVI|AIVI
AIVL|AIVL
AIZ|AIZ
AIZN|AIZN
AJG|AJG
AJRD|AJRD
AJX|AJX
AJXA|AJXA
AKA|AKA
AKO.A|AKO.A
AKO.B|AKO.B
AKR|AKR
AL|AL
ALpA|AL-A
ALB|ALB
ALC|ALC
ALCC|ALCC
ALE|ALE
ALEX|ALEX
ALG|ALG
ALIT|ALIT
ALK|ALK
ALL|ALL
ALLpB|ALL-B
ALLpG|ALL-G
ALLpH|ALL-H
ALLpI|ALL-I
ALLE|ALLE
ALLG|ALLG
ALLG.WS|ALLG+
ALLY|ALLY
ALSN|ALSN
ALTG|ALTG
ALTGpA|ALTG-A
ALTL|ALTL
ALV|ALV
ALX|ALX
AM|AM
AMAM|AMAM
AMAX|AMAX
AMBC|AMBC
AMBC.WS|AMBC+
AMBO|AMBO
AMBP|AMBP
AMBP.WS|AMBP+
AMC|AMC
AMCR|AMCR
AME|AME
AMG|AMG
AMH|AMH
AMHpG|AMH-G
AMHpH|AMH-H
AMJ|AMJ
AMK|AMK
AMLP|AMLP
AMN|AMN
AMNA|AMNA
AMND|AMND
AMOM|AMOM
AMOV|AMOV
AMP|AMP
AMPE|AMPE
AMPI|AMPI
AMPI.U|AMPI=
AMPS|AMPS
AMPX|AMPX
AMPX.WS|AMPX+
AMPY|AMPY
AMR|AMR
AMRC|AMRC
AMRX|AMRX
AMS|AMS
AMT|AMT
AMTD|AMTD
AMTR|AMTR
AMUB|AMUB
AMWL|AMWL
AMX|AMX
AMZA|AMZA
AN|AN
ANAC|ANAC
ANAC.U|ANAC=
ANAC.WS|ANAC+
ANET|ANET
ANEW|ANEW
ANF|ANF
ANVS|ANVS
AOA|AOA
AOD|AOD
AOK|AOK
AOM|AOM
AOMR|AOMR
AON|AON
AOR|AOR
AORT|AORT
AOS|AOS
AP|AP
AP.WS|AP+
APAM|APAM
APCA|APCA
APCA.U|APCA=
APCA.WS|APCA+
APD|APD
APE|APE
APG|APG
APGB|APGB
APGB.U|APGB=
APGB.WS|APGB+
APH|APH
APLE|APLE
APN|APN
APN.U|APN=
APN.WS|APN+
APO|APO
APRN|APRN
APRT|APRT
APRW|APRW
APRZ|APRZ
APT|APT
APTV|APTV
APTVpA|APTV-A
APXH|APXH
AQGX|AQGX
AQN|AQN
AQNA|AQNA
AQNB|AQNB
AQNU|AQNU
AQUA|AQUA
AR|AR
ARB|ARB
ARC|ARC
ARCH|ARCH
ARCM|ARCM
ARCO|ARCO
ARDC|ARDC
ARE|ARE
AREN|AREN
ARES|ARES
ARGD|ARGD
ARGO|ARGO
ARGOpA|ARGO-A
ARGT|ARGT
ARI|ARI
ARIS|ARIS
ARKF|ARKF
ARKG|ARKG
ARKK|ARKK
ARKQ|ARKQ
ARKW|ARKW
ARKX|ARKX
ARL|ARL
ARLO|ARLO
ARMK|ARMK
ARMP|ARMP
ARMR|ARMR
ARNC|ARNC
AROC|AROC
ARR|ARR
ARRpC|ARR-C
ARW|ARW
ASA|ASA
ASAI|ASAI
ASAN|ASAN
ASB|ASB
ASBpE|ASB-E
ASBpF|ASB-F
ASC|ASC
ASEA|ASEA
ASG|ASG
ASGI|ASGI
ASGN|ASGN
ASH|ASH
ASHR|ASHR
ASHS|ASHS
ASHX|ASHX
ASIX|ASIX
ASM|ASM
ASPN|ASPN
ASPY|ASPY
ASR|ASR
ASX|ASX
ASXC|ASXC
ATA|ATA
ATA.U|ATA=
ATA.WS|ATA+
ATAQ|ATAQ
ATAQ.U|ATAQ=
ATCO|ATCO
ATCOpD|ATCO-D
ATCOpH|ATCO-H
ATCOpI|ATCO-I
ATEK|ATEK
ATEK.U|ATEK=
ATEK.WS|ATEK+
ATEN|ATEN
ATEST|ATEST
ATEST.A|ATEST.A
ATEST.B|ATEST.B
ATEST.C|ATEST.C
ATFV|ATFV
ATGE|ATGE
ATHpA|ATH-A
ATHpB|ATH-B
ATHpC|ATH-C
ATHpD|ATH-D
ATHM|ATHM
ATI|ATI
ATIP|ATIP
ATIP.WS|ATIP+
ATKR|ATKR
ATMP|ATMP
ATNM|ATNM
ATO|ATO
ATR|ATR
ATTO|ATTO
ATUS|ATUS
AU|AU
AUD|AUD
AUGZ|AUGZ
AUMN|AUMN
AUSF|AUSF
AUST|AUST
AUY|AUY
AVA|AVA
AVAL|AVAL
AVB|AVB
AVD|AVD
AVDE|AVDE
AVDV|AVDV
AVEM|AVEM
AVES|AVES
AVGE|AVGE
AVIE|AVIE
AVIG|AVIG
AVIV|AVIV
AVK|AVK
AVLV|AVLV
AVMU|AVMU
AVNS|AVNS
AVNT|AVNT
AVRE|AVRE
AVSC|AVSC
AVSD|AVSD
AVSE|AVSE
AVSF|AVSF
AVSU|AVSU
AVTR|AVTR
AVUS|AVUS
AVUV|AVUV
AVY|AVY
AVYA|AVYA
AWAY|AWAY
AWF|AWF
AWI|AWI
AWK|AWK
AWP|AWP
AWR|AWR
AWX|AWX
AWYX|AWYX
AX|AX
AXAC|AXAC
AXACr|AXAC^
AXAC.WS|AXAC+
AXL|AXL
AXP|AXP
AXR|AXR
AXS|AXS
AXSpE|AXS-E
AXTA|AXTA
AYI|AYI
AYX|AYX
AZEK|AZEK
AZO|AZO
AZRE|AZRE
AZTD|AZTD
AZUL|AZUL
AZZ|AZZ
B|B
BA|BA
BAB|BAB
BABA|BABA
BAC|BAC
BACpB|BAC-B
BACpE|BAC-E
BACpK|BAC-K
BACpL|BAC-L
BACpM|BAC-M
BACpN|BAC-N
BACpO|BAC-O
BACpP|BAC-P
BACpQ|BAC-Q
BACpS|BAC-S
BACA|BACA
BACA.U|BACA=
BACA.WS|BACA+
BAD|BAD
BAH|BAH
BAK|BAK
BAL|BAL
BALL|BALL
BALT|BALT
BALY|BALY
BAM|BAM
BAMw|BAM#
BAMH|BAMH
BAMI|BAMI
BAMR|BAMR
BANC|BANC
BAP|BAP
BAPR|BAPR
BAR|BAR
BARK|BARK
BARK.WS|BARK+
BATL|BATL
BATT|BATT
BAUG|BAUG
BAX|BAX
BB|BB
BBAI|BBAI
BBAI.WS|BBAI+
BBAR|BBAR
BBAX|BBAX
BBC|BBC
BBCA|BBCA
BBD|BBD
BBDC|BBDC
BBDO|BBDO
BBEU|BBEU
BBIN|BBIN
BBJP|BBJP
BBLN|BBLN
BBLU|BBLU
BBMC|BBMC
BBN|BBN
BBP|BBP
BBRE|BBRE
BBSA|BBSA
BBSC|BBSC
BBU|BBU
BBUC|BBUC
BBUS|BBUS
BBVA|BBVA
BBW|BBW
BBWI|BBWI
BBY|BBY
BC|BC
BCpA|BC-A
BCpB|BC-B
BCpC|BC-C
BCAT|BCAT
BCC|BCC
BCD|BCD
BCDF|BCDF
BCE|BCE
BCH|BCH
BCI|BCI
BCIM|BCIM
BCM|BCM
BCO|BCO
BCS|BCS
BCSF|BCSF
BCV|BCV
BCVpA|BCV-A
BCX|BCX
BDC|BDC
BDCX|BDCX
BDCZ|BDCZ
BDEC|BDEC
BDJ|BDJ
BDL|BDL
BDN|BDN
BDRY|BDRY
BDX|BDX
BDXB|BDXB
BE|BE
BECO|BECO
BEDU|BEDU
BEDZ|BEDZ
BEKE|BEKE
BEN|BEN
BEP|BEP
BEPpA|BEP-A
BEPC|BEPC
BEPH|BEPH
BEPI|BEPI
BERY|BERY
BERZ|BERZ
BEST|BEST
BETZ|BETZ
BF.A|BF.A
BF.B|BF.B
BFAC|BFAC
BFAC.U|BFAC=
BFAC.WS|BFAC+
BFAM|BFAM
BFEB|BFEB
BFH|BFH
BFIX|BFIX
BFK|BFK
BFLY|BFLY
BFLY.WS|BFLY+
BFOR|BFOR
BFS|BFS
BFSpD|BFS-D
BFSpE|BFS-E
BFTR|BFTR
BFZ|BFZ
BG|BG
BGB|BGB
BGH|BGH
BGI|BGI
BGLD|BGLD
BGR|BGR
BGS|BGS
BGSF|BGSF
BGSX|BGSX
BGSX.U|BGSX=
BGSX.WS|BGSX+
BGT|BGT
BGX|BGX
BGY|BGY
BH|BH
BH.A|BH.A
BHB|BHB
BHC|BHC
BHE|BHE
BHG|BHG
BHIL|BHIL
BHIL.WS|BHIL+
BHK|BHK
BHLB|BHLB
BHM|BHM
BHP|BHP
BHR|BHR
BHRpB|BHR-B
BHRpD|BHR-D
BHV|BHV
BHVN|BHVN
BIBL|BIBL
BIDS|BIDS
BIG|BIG
BIGZ|BIGZ
BIL|BIL
BILL|BILL
BILS|BILS
BIO|BIO
BIO.B|BIO.B
BIP|BIP
BIPpA|BIP-A
BIPpB|BIP-B
BIPC|BIPC
BIPH|BIPH
BIPI|BIPI
BIT|BIT
BITE|BITE
BITE.U|BITE=
BITE.WS|BITE+
BITI|BITI
BITO|BITO
BITQ|BITQ
BIV|BIV
BIZD|BIZD
BJ|BJ
BJAN|BJAN
BJUL|BJUL
BJUN|BJUN
BK|BK
BKAG|BKAG
BKCI|BKCI
BKD|BKD
BKDT|BKDT
BKE|BKE
BKEM|BKEM
BKES|BKES
BKF|BKF
BKGI|BKGI
BKH|BKH
BKHY|BKHY
BKI|BKI
BKIE|BKIE
BKIS|BKIS
BKKT|BKKT
BKKT.WS|BKKT+
BKLC|BKLC
BKLN|BKLN
BKMC|BKMC
BKN|BKN
BKSB|BKSB
BKSE|BKSE
BKSY|BKSY
BKSY.WS|BKSY+
BKT|BKT
BKTI|BKTI
BKU|BKU
BKUI|BKUI
BKUS|BKUS
BLCO|BLCO
BLD|BLD
BLDG|BLDG
BLDR|BLDR
BLE|BLE
BLES|BLES
BLHY|BLHY
BLK|BLK
BLKC|BLKC
BLND|BLND
BLOK|BLOK
BLUA|BLUA
BLUA.U|BLUA=
BLUA.WS|BLUA+
BLV|BLV
BLW|BLW
BLX|BLX
BMA|BMA
BMAC|BMAC
BMAC.U|BMAC=
BMAC.WS|BMAC+
BMAR|BMAR
BMAY|BMAY
BME|BME
BMED|BMED
BMEZ|BMEZ
BMI|BMI
BMLpG|BML-G
BMLpH|BML-H
BMLpJ|BML-J
BMLpL|BML-L
BMN|BMN
BMO|BMO
BMTX|BMTX
BMTX.WS|BMTX+
BMY|BMY
BNw|BN#
BNDC|BNDC
BNDD|BNDD
BNDI|BNDI
BNE|BNE
BNED|BNED
BNGE|BNGE
BNKD|BNKD
BNKU|BNKU
BNL|BNL
BNO|BNO
BNOV|BNOV
BNS|BNS
BNY|BNY
BOAC|BOAC
BOAC.U|BOAC=
BOAC.WS|BOAC+
BOAT|BOAT
BOC|BOC
BOCT|BOCT
BODY|BODY
BODY.WS|BODY+
BOE|BOE
BOH|BOH
BOHpA|BOH-A
BOIL|BOIL
BOND|BOND
BOOT|BOOT
BORR|BORR
BOSS|BOSS
BOUT|BOUT
BOWL|BOWL
BOX|BOX
BOXD|BOXD
BOXD.WS|BOXD+
BP|BP
BPAY|BPAY
BPT|BPT
BQ|BQ
BR|BR
BRBR|BRBR
BRBS|BRBS
BRC|BRC
BRCC|BRCC
BRD|BRD
BRD.U|BRD=
BRD.WS|BRD+
BRDG|BRDG
BRDS|BRDS
BRDS.WS|BRDS+
BRF|BRF
BRFS|BRFS
BRK.A|BRK.A
BRK.B|BRK.B
BRKY|BRKY
BRLN|BRLN
BRMK|BRMK
BRMK.WS|BRMK+
BRN|BRN
BRO|BRO
BROS|BROS
BRSP|BRSP
BRT|BRT
BRW|BRW
BRX|BRX
BRZU|BRZU
BSAC|BSAC
BSAQ|BSAQ
BSAQ.U|BSAQ=
BSAQ.WS|BSAQ+
BSBR|BSBR
BSEA|BSEA
BSEP|BSEP
BSIG|BSIG
BSL|BSL
BSM|BSM
BSMX|BSMX
BST|BST
BSTP|BSTP
BSTZ|BSTZ
BSV|BSV
BSX|BSX
BSXpA|BSX-A
BTA|BTA
BTAL|BTAL
BTCM|BTCM
BTCR|BTCR
BTEK|BTEK
BTG|BTG
BTHM|BTHM
BTI|BTI
BTN|BTN
BTO|BTO
BTT|BTT
BTTR|BTTR
BTU|BTU
BTZ|BTZ
BUCK|BUCK
BUD|BUD
BUFB|BUFB
BUFD|BUFD
BUFF|BUFF
BUFG|BUFG
BUFQ|BUFQ
BUFR|BUFR
BUFT|BUFT
BUI|BUI
BUL|BUL
BULZ|BULZ
BUR|BUR
BURL|BURL
BUYW|BUYW
BUYZ|BUYZ
BUZZ|BUZZ
BV|BV
BVH|BVH
BVN|BVN
BW|BW
BWpA|BW-A
BWA|BWA
BWEB|BWEB
BWG|BWG
BWNB|BWNB
BWSN|BWSN
BWX|BWX
BWXT|BWXT
BWZ|BWZ
BX|BX
BXC|BXC
BXMT|BXMT
BXMX|BXMX
BXP|BXP
BXSL|BXSL
BY|BY
BYD|BYD
BYLD|BYLD
BYM|BYM
BYN|BYN
BYN.U|BYN=
BYN.WS|BYN+
BYRE|BYRE
BYTE|BYTE
BZH|BZH
BZQ|BZQ
C|C
CpJ|C-J
CpK|C-K
CpN|C-N
CAAP|CAAP
CABO|CABO
CACI|CACI
CADE|CADE
CADEpA|CADE-A
CAE|CAE
CAF|CAF
CAG|CAG
CAH|CAH
CAJ|CAJ
CAL|CAL
CALF|CALF
CALX|CALX
CANE|CANE
CANF|CANF
CANG|CANG
CANO|CANO
CANO.WS|CANO+
CAPE|CAPE
CAPL|CAPL
CARR|CARR
CARS|CARS
CARY|CARY
CAT|CAT
CATO|CATO
CB|CB
CBD|CBD
CBH|CBH
CBL|CBL
CBLS|CBLS
CBO|CBO
CBOE|CBOE
CBON|CBON
CBRE|CBRE
CBSE|CBSE
CBT|CBT
CBU|CBU
CBX|CBX
CBZ|CBZ
CC|CC
CCCS|CCCS
CCEL|CCEL
CCF|CCF
CCI|CCI
CCJ|CCJ
CCK|CCK
CCL|CCL
CCM|CCM
CCO|CCO
CCOR|CCOR
CCRD|CCRD
CCRV|CCRV
CCS|CCS
CCU|CCU
CCV|CCV
CCV.U|CCV=
CCV.WS|CCV+
CCVI|CCVI
CCVI.U|CCVI=
CCVI.WS|CCVI+
CCZ|CCZ
CDAY|CDAY
CDE|CDE
CDRpB|CDR-B
CDRpC|CDR-C
CDRE|CDRE
CDX|CDX
CE|CE
CEA|CEA
CEE|CEE
CEF|CEF
CEFD|CEFD
CEFS|CEFS
CEI|CEI
CEIX|CEIX
CELGr|CELG^
CEM|CEM
CEMB|CEMB
CEN|CEN
CEPU|CEPU
CEQP|CEQP
CEQPp|CEQP-
CET|CET
CEV|CEV
CEW|CEW
CF|CF
CFCV|CFCV
CFG|CFG
CFGpD|CFG-D
CFGpE|CFG-E
CFR|CFR
CFRpB|CFR-B
CGA|CGA
CGAU|CGAU
CGCP|CGCP
CGDV|CGDV
CGGO|CGGO
CGGR|CGGR
CGMS|CGMS
CGMU|CGMU
CGSD|CGSD
CGUS|CGUS
CGV|CGV
CGW|CGW
CGXU|CGXU
CHAA|CHAA
CHAA.U|CHAA=
CHAD|CHAD
CHAU|CHAU
CHCT|CHCT
CHD|CHD
CHE|CHE
CHGG|CHGG
CHGX|CHGX
CHH|CHH
CHIC|CHIC
CHIE|CHIE
CHIH|CHIH
CHII|CHII
CHIK|CHIK
CHIM|CHIM
CHIQ|CHIQ
CHIR|CHIR
CHIS|CHIS
CHIU|CHIU
CHIX|CHIX
CHMI|CHMI
CHMIpA|CHMI-A
CHMIpB|CHMI-B
CHN|CHN
CHPT|CHPT
CHRA|CHRA
CHRB|CHRB
CHS|CHS
CHT|CHT
CHWY|CHWY
CI|CI
CIA|CIA
CIAN|CIAN
CIB|CIB
CIEN|CIEN
CIF|CIF
CIG|CIG
CIG.C|CIG.C
CII|CII
CIK|CIK
CIM|CIM
CIMpA|CIM-A
CIMpB|CIM-B
CIMpC|CIM-C
CIMpD|CIM-D
CINT|CINT
CIO|CIO
CIOpA|CIO-A
CION|CION
CIR|CIR
CIVI|CIVI
CIX|CIX
CIXX|CIXX
CKX|CKX
CL|CL
CLAA|CLAA
CLAA.U|CLAA=
CLAA.WS|CLAA+
CLAS|CLAS
CLAS.U|CLAS=
CLAS.WS|CLAS+
CLB|CLB
CLBR|CLBR
CLBR.U|CLBR=
CLBR.WS|CLBR+
CLDL|CLDL
CLDT|CLDT
CLDTpA|CLDT-A
CLF|CLF
CLH|CLH
CLIM|CLIM
CLIM.U|CLIM=
CLIX|CLIX
CLM|CLM
CLNR|CLNR
CLOI|CLOI
CLPR|CLPR
CLS|CLS
CLSA|CLSA
CLSC|CLSC
CLSE|CLSE
CLSM|CLSM
CLTL|CLTL
CLVT|CLVT
CLVTpA|CLVT-A
CLW|CLW
CLX|CLX
CM|CM
CMA|CMA
CMBS|CMBS
CMC|CMC
CMCL|CMCL
CMCM|CMCM
CMDY|CMDY
CMF|CMF
CMG|CMG
CMI|CMI
CMP|CMP
CMRE|CMRE
CMREpB|CMRE-B
CMREpC|CMRE-C
CMREpD|CMRE-D
CMREpE|CMRE-E
CMS|CMS
CMSpB|CMS-B
CMSpC|CMS-C
CMSA|CMSA
CMSC|CMSC
CMSD|CMSD
CMT|CMT
CMTG|CMTG
CMU|CMU
CN|CN
CNA|CNA
CNBS|CNBS
CNC|CNC
CND|CND
CND.U|CND=
CND.WS|CND+
CNDA|CNDA
CNDA.U|CNDA=
CNDA.WS|CNDA+
CNDB|CNDB
CNDB.U|CNDB=
CNDB.WS|CNDB+
CNF|CNF
CNHI|CNHI
CNI|CNI
CNK|CNK
CNM|CNM
CNMD|CNMD
CNNE|CNNE
CNO|CNO
CNOpA|CNO-A
CNP|CNP
CNQ|CNQ
CNRG|CNRG
CNS|CNS
CNX|CNX
CNXT|CNXT
CNYA|CNYA
CO|CO
CODI|CODI
CODIpA|CODI-A
CODIpB|CODI-B
CODIpC|CODI-C
COE|COE
COF|COF
COFpI|COF-I
COFpJ|COF-J
COFpK|COF-K
COFpL|COF-L
COFpN|COF-N
COHN|COHN
COLD|COLD
COM|COM
COMB|COMB
COMP|COMP
COO|COO
COOK|COOK
COP|COP
COPX|COPX
CORN|CORN
CORP|CORP
CORR|CORR
CORRpA|CORR-A
CORS|CORS
CORS.U|CORS=
CORS.WS|CORS+
COTY|COTY
COUR|COUR
COW|COW
COWZ|COWZ
CP|CP
CPA|CPA
CPAC|CPAC
CPB|CPB
CPE|CPE
CPER|CPER
CPF|CPF
CPG|CPG
CPHI|CPHI
CPI|CPI
CPII|CPII
CPK|CPK
CPNG|CPNG
CPRI|CPRI
CPS|CPS
CPT|CPT
CPTK|CPTK
CPTK.U|CPTK=
CPUH|CPUH
CPUH.U|CPUH=
CPUH.WS|CPUH+
CQP|CQP
CQQQ|CQQQ
CR|CR
CRAK|CRAK
CRBG|CRBG
CRBN|CRBN
CRC|CRC
CRD.A|CRD.A
CRD.B|CRD.B
CRF|CRF
CRGY|CRGY
CRH|CRH
CRI|CRI
CRIT|CRIT
CRK|CRK
CRL|CRL
CRM|CRM
CRPT|CRPT
CRS|CRS
CRT|CRT
CRUZ|CRUZ
CRYP|CRYP
CS|CS
CSAN|CSAN
CSD|CSD
CSH|CSH
CSHI|CSHI
CSL|CSL
CSM|CSM
CSR|CSR
CSRpC|CSR-C
CSTA|CSTA
CSTA.U|CSTA=
CSTA.WS|CSTA+
CSTM|CSTM
CSV|CSV
CTA|CTA
CTApA|CTA-A
CTApB|CTA-B
CTBB|CTBB
CTDD|CTDD
CTEST|CTEST
CTEST.E|CTEST.E
CTEST.G|CTEST.G
CTEST.L|CTEST.L
CTEST.O|CTEST.O
CTEST.S|CTEST.S
CTEST.V|CTEST.V
CTEX|CTEX
CTGO|CTGO
CTLT|CTLT
CTM|CTM
CTO|CTO
CTOpA|CTO-A
CTOS|CTOS
CTOS.WS|CTOS+
CTR|CTR
CTRA|CTRA
CTRE|CTRE
CTS|CTS
CTV|CTV
CTV.WS|CTV+
CTVA|CTVA
CUBB|CUBB
CUBE|CUBE
CUBI|CUBI
CUBIpE|CUBI-E
CUBIpF|CUBI-F
CUBS|CUBS
CUK|CUK
CULP|CULP
CURE|CURE
CURO|CURO
CURV|CURV
CUT|CUT
CUZ|CUZ
CVAR|CVAR
CVE|CVE
CVE.WS|CVE+
CVEO|CVEO
CVI|CVI
CVII|CVII
CVII.U|CVII=
CVII.WS|CVII+
CVM|CVM
CVNA|CVNA
CVR|CVR
CVS|CVS
CVU|CVU
CVX|CVX
CVY|CVY
CW|CW
CWAN|CWAN
CWB|CWB
CWEB|CWEB
CWEN|CWEN
CWEN.A|CWEN.A
CWH|CWH
CWI|CWI
CWK|CWK
CWS|CWS
CWT|CWT
CX|CX
CXAC|CXAC
CXAC.U|CXAC=
CXAC.WS|CXAC+
CXE|CXE
CXH|CXH
CXM|CXM
CXW|CXW
CYA|CYA
CYB|CYB
CYBN|CYBN
CYD|CYD
CYH|CYH
CZA|CZA
CZOO|CZOO
CZOO.WS|CZOO+
D|D
DAC|DAC
DAL|DAL
DALT|DALT
DAN|DAN
DAO|DAO
DAPR|DAPR
DAR|DAR
DASH|DASH
DAT|DAT
DAUG|DAUG
DAVA|DAVA
DB|DB
DBA|DBA
DBAW|DBAW
DBB|DBB
DBC|DBC
DBD|DBD
DBE|DBE
DBEF|DBEF
DBEH|DBEH
DBEM|DBEM
DBEU|DBEU
DBEZ|DBEZ
DBGR|DBGR
DBI|DBI
DBJA|DBJA
DBJP|DBJP
DBL|DBL
DBMF|DBMF
DBND|DBND
DBO|DBO
DBOC|DBOC
DBP|DBP
DBRG|DBRG
DBRGpH|DBRG-H
DBRGpI|DBRG-I
DBRGpJ|DBRG-J
DBS|DBS
DBV|DBV
DC|DC
DC.WS|DC+
DCF|DCF
DCI|DCI
DCO|DCO
DCP|DCP
DCPpB|DCP-B
DCPpC|DCP-C
DD|DD
DDD|DDD
DDEC|DDEC
DDF|DDF
DDL|DDL
DDLS|DDLS
DDM|DDM
DDS|DDS
DDT|DDT
DDWM|DDWM
DE|DE
DEA|DEA
DECK|DECK
DECT|DECT
DECW|DECW
DECZ|DECZ
DEED|DEED
DEEF|DEEF
DEEP|DEEP
DEF|DEF
DEFI|DEFI
DEHP|DEHP
DEI|DEI
DEIF|DEIF
DELL|DELL
DEM|DEM
DEN|DEN
DEO|DEO
DES|DES
DESP|DESP
DEUS|DEUS
DEW|DEW
DEX|DEX
DFAC|DFAC
DFAE|DFAE
DFAI|DFAI
DFAR|DFAR
DFAS|DFAS
DFAT|DFAT
DFAU|DFAU
DFAX|DFAX
DFCF|DFCF
DFE|DFE
DFEB|DFEB
DFEM|DFEM
DFEN|DFEN
DFEV|DFEV
DFH|DFH
DFHY|DFHY
DFIC|DFIC
DFIN|DFIN
DFIP|DFIP
DFIS|DFIS
DFIV|DFIV
DFJ|DFJ
DFND|DFND
DFNL|DFNL
DFNM|DFNM
DFNV|DFNV
DFP|DFP
DFRA|DFRA
DFS|DFS
DFSB|DFSB
DFSD|DFSD
DFSE|DFSE
DFSI|DFSI
DFSU|DFSU
DFSV|DFSV
DFUS|DFUS
DFUV|DFUV
DG|DG
DGIN|DGIN
DGL|DGL
DGP|DGP
DGRO|DGRO
DGS|DGS
DGT|DGT
DGX|DGX
DGZ|DGZ
DHF|DHF
DHI|DHI
DHR|DHR
DHRpB|DHR-B
DHS|DHS
DHT|DHT
DHX|DHX
DHY|DHY
DIA|DIA
DIAL|DIAL
DIAX|DIAX
DIEM|DIEM
DIG|DIG
DIHP|DIHP
DIM|DIM
DIN|DIN
DINO|DINO
DINT|DINT
DIS|DIS
DISV|DISV
DIT|DIT
DIV|DIV
DIVB|DIVB
DIVI|DIVI
DIVO|DIVO
DIVS|DIVS
DIVZ|DIVZ
DJAN|DJAN
DJCB|DJCB
DJD|DJD
DJIA|DJIA
DJP|DJP
DJUL|DJUL
DJUN|DJUN
DK|DK
DKL|DKL
DKS|DKS
DLA|DLA
DLB|DLB
DLN|DLN
DLNG|DLNG
DLNGpA|DLNG-A
DLNGpB|DLNG-B
DLR|DLR
DLRpJ|DLR-J
DLRpK|DLR-K
DLRpL|DLR-L
DLS|DLS
DLX|DLX
DLY|DLY
DM|DM
DMA|DMA
DMAR|DMAR
DMAY|DMAY
DMB|DMB
DMCY|DMCY
DMDV|DMDV
DMF|DMF
DMO|DMO
DMS|DMS
DMS.WS|DMS+
DMYS|DMYS
DMYS.U|DMYS=
DMYS.WS|DMYS+
DMYY|DMYY
DMYY.U|DMYY=
DMYY.WS|DMYY+
DNA|DNA
DNA.WS|DNA+
DNB|DNB
DNL|DNL
DNMR|DNMR
DNN|DNN
DNOV|DNOV
DNOW|DNOW
DNP|DNP
DNZ|DNZ
DNZ.U|DNZ=
DNZ.WS|DNZ+
DO|DO
DOC|DOC
DOCN|DOCN
DOCS|DOCS
DOCT|DOCT
DOG|DOG
DOL|DOL
DOLE|DOLE
DOMA|DOMA
DOMA.WS|DOMA+
DON|DON
DOOR|DOOR
DOUG|DOUG
DOV|DOV
DOW|DOW
DOZR|DOZR
DPG|DPG
DPSI|DPSI
DPST|DPST
DPZ|DPZ
DQ|DQ
DRD|DRD
DRH|DRH
DRHpA|DRH-A
DRI|DRI
DRIP|DRIP
DRLL|DRLL
DRN|DRN
DRQ|DRQ
DRSK|DRSK
DRV|DRV
DS|DS
DSpB|DS-B
DSpC|DS-C
DSpD|DS-D
DSAQ|DSAQ
DSAQ.U|DSAQ=
DSCF|DSCF
DSEP|DSEP
DSI|DSI
DSJA|DSJA
DSL|DSL
DSM|DSM
DSMC|DSMC
DSOC|DSOC
DSS|DSS
DSTL|DSTL
DSTX|DSTX
DSU|DSU
DSX|DSX
DSXpB|DSX-B
DT|DT
DTB|DTB
DTC|DTC
DTD|DTD
DTE|DTE
DTEC|DTEC
DTF|DTF
DTG|DTG
DTH|DTH
DTLAp|DTLA-
DTM|DTM
DTRE|DTRE
DTW|DTW
DUDE|DUDE
DUG|DUG
DUHP|DUHP
DUK|DUK
DUKpA|DUK-A
DUKB|DUKB
DURA|DURA
DUSA|DUSA
DUSL|DUSL
DUST|DUST
DV|DV
DVA|DVA
DVN|DVN
DVND|DVND
DVYA|DVYA
DVYE|DVYE
DWAT|DWAT
DWCR|DWCR
DWLD|DWLD
DWM|DWM
DWMF|DWMF
DWX|DWX
DX|DX
DXpC|DX-C
DXC|DXC
DXD|DXD
DXF|DXF
DXJ|DXJ
DY|DY
DYLD|DYLD
DYNF|DYNF
DZZ|DZZ
E|E
EAD|EAD
EAF|EAF
EAFD|EAFD
EAGG|EAGG
EAI|EAI
EAOA|EAOA
EAOK|EAOK
EAOM|EAOM
EAOR|EAOR
EAPR|EAPR
EARN|EARN
EASG|EASG
EAT|EAT
EATV|EATV
EATZ|EATZ
EB|EB
EBF|EBF
EBLU|EBLU
EBND|EBND
EBR|EBR
EBR.B|EBR.B
EBS|EBS
EC|EC
ECAT|ECAT
ECC|ECC
ECCpD|ECC-D
ECCC|ECCC
ECCV|ECCV
ECCW|ECCW
ECCX|ECCX
ECF|ECF
ECFpA|ECF-A
ECH|ECH
ECL|ECL
ECLN|ECLN
ECNS|ECNS
ECON|ECON
ECOZ|ECOZ
ECVT|ECVT
ED|ED
EDC|EDC
EDD|EDD
EDEN|EDEN
EDF|EDF
EDI|EDI
EDIV|EDIV
EDN|EDN
EDOG|EDOG
EDOW|EDOW
EDR|EDR
EDU|EDU
EDV|EDV
EDZ|EDZ
EE|EE
EEA|EEA
EELV|EELV
EEM|EEM
EEMD|EEMD
EEMO|EEMO
EEMS|EEMS
EEMV|EEMV
EEMX|EEMX
EES|EES
EET|EET
EEV|EEV
EEX|EEX
EFA|EFA
EFAD|EFAD
EFAV|EFAV
EFAX|EFAX
EFC|EFC
EFCpA|EFC-A
EFCpB|EFC-B
EFG|EFG
EFIV|EFIV
EFIX|EFIX
EFNL|EFNL
EFO|EFO
EFR|EFR
EFSH|EFSH
EFT|EFT
EFU|EFU
EFV|EFV
EFX|EFX
EFXT|EFXT
EFZ|EFZ
EGF|EGF
EGGF|EGGF
EGGF.U|EGGF=
EGGF.WS|EGGF+
EGIS|EGIS
EGO|EGO
EGP|EGP
EGPT|EGPT
EGY|EGY
EHAB|EHAB
EHC|EHC
EHI|EHI
EIC|EIC
EICA|EICA
EIDO|EIDO
EIG|EIG
EIM|EIM
EINC|EINC
EIPX|EIPX
EIRL|EIRL
EIS|EIS
EIX|EIX
EJAN|EJAN
EJUL|EJUL
EKAR|EKAR
EL|EL
ELA|ELA
ELAN|ELAN
ELAT|ELAT
ELC|ELC
ELD|ELD
ELF|ELF
ELLO|ELLO
ELMD|ELMD
ELME|ELME
ELP|ELP
ELQD|ELQD
ELS|ELS
ELV|ELV
ELVT|ELVT
EMAN|EMAN
EMBD|EMBD
EMCA|EMCA
EMCH|EMCH
EMCR|EMCR
EMD|EMD
EMDV|EMDV
EME|EME
EMF|EMF
EMFM|EMFM
EMFQ|EMFQ
EMGC|EMGC
EMGD|EMGD
EMGF|EMGF
EMHC|EMHC
EMHY|EMHY
EMLC|EMLC
EMLP|EMLP
EMMF|EMMF
EMN|EMN
EMNT|EMNT
EMO|EMO
EMP|EMP
EMPW|EMPW
EMQQ|EMQQ
EMR|EMR
EMSG|EMSG
EMTL|EMTL
EMTY|EMTY
EMX|EMX
EMZA|EMZA
ENB|ENB
ENBA|ENBA
ENFN|ENFN
ENFR|ENFR
ENIC|ENIC
ENJ|ENJ
ENLC|ENLC
ENO|ENO
ENOR|ENOR
ENOV|ENOV
ENR|ENR
ENRG|ENRG
ENS|ENS
ENSV|ENSV
ENTR|ENTR
ENV|ENV
ENVA|ENVA
ENX|ENX
ENZ|ENZ
EOCT|EOCT
EOCW|EOCW
EOCW.U|EOCW=
EOCW.WS|EOCW+
EOD|EOD
EOG|EOG
EOI|EOI
EOS|EOS
EOT|EOT
EP|EP
EPpC|EP-C
EPAC|EPAC
EPAM|EPAM
EPC|EPC
EPD|EPD
EPHE|EPHE
EPI|EPI
EPM|EPM
EPOL|EPOL
EPP|EPP
EPR|EPR
EPRpC|EPR-C
EPRpE|EPR-E
EPRpG|EPR-G
EPRF|EPRF
EPRT|EPRT
EPS|EPS
EPU|EPU
EPV|EPV
EPWR|EPWR
EPWR.U|EPWR=
EQAL|EQAL
EQC|EQC
EQCpD|EQC-D
EQH|EQH
EQHpA|EQH-A
EQHpC|EQH-C
EQHA|EQHA
EQHA.U|EQHA=
EQL|EQL
EQNR|EQNR
EQOP|EQOP
EQR|EQR
EQS|EQS
EQT|EQT
EQUL|EQUL
EQWL|EQWL
EQX|EQX
ERC|ERC
ERF|ERF
ERH|ERH
ERJ|ERJ
ERM|ERM
ERO|ERO
ERSX|ERSX
ERTH|ERTH
ERX|ERX
ERY|ERY
ES|ES
ESAB|ESAB
ESBA|ESBA
ESCR|ESCR
ESE|ESE
ESEB|ESEB
ESG|ESG
ESGA|ESGA
ESGB|ESGB
ESGG|ESGG
ESGN|ESGN
ESGS|ESGS
ESGV|ESGV
ESGY|ESGY
ESHY|ESHY
ESI|ESI
ESIX|ESIX
ESM|ESM
ESM.U|ESM=
ESM.WS|ESM+
ESML|ESML
ESMT|ESMT
ESNT|ESNT
ESP|ESP
ESRT|ESRT
ESS|ESS
ESTC|ESTC
ESTE|ESTE
ESUS|ESUS
ET|ET
ETpC|ET-C
ETpD|ET-D
ETpE|ET-E
ETB|ETB
ETD|ETD
ETG|ETG
ETHO|ETHO
ETIp|ETI-
ETJ|ETJ
ETN|ETN
ETO|ETO
ETR|ETR
ETRN|ETRN
ETV|ETV
ETW|ETW
ETWO|ETWO
ETWO.WS|ETWO+
ETX|ETX
ETY|ETY
EUDG|EUDG
EUDV|EUDV
EUM|EUM
EUO|EUO
EURL|EURL
EURN|EURN
EUSA|EUSA
EUSB|EUSB
EUSC|EUSC
EVA|EVA
EVAV|EVAV
EVBN|EVBN
EVC|EVC
EVE|EVE
EVE.U|EVE=
EVE.WS|EVE+
EVEN|EVEN
EVEX|EVEX
EVEX.WS|EVEX+
EVF|EVF
EVG|EVG
EVH|EVH
EVI|EVI
EVM|EVM
EVN|EVN
EVNT|EVNT
EVR|EVR
EVRG|EVRG
EVRI|EVRI
EVT|EVT
EVTC|EVTC
EVTL|EVTL
EVTL.WS|EVTL+
EVV|EVV
EVX|EVX
EW|EW
EWA|EWA
EWC|EWC
EWCO|EWCO
EWD|EWD
EWG|EWG
EWGS|EWGS
EWH|EWH
EWI|EWI
EWJ|EWJ
EWK|EWK
EWL|EWL
EWM|EWM
EWMC|EWMC
EWN|EWN
EWO|EWO
EWP|EWP
EWQ|EWQ
EWRE|EWRE
EWS|EWS
EWSC|EWSC
EWT|EWT
EWU|EWU
EWUS|EWUS
EWV|EWV
EWW|EWW
EWX|EWX
EWY|EWY
EWZ|EWZ
EXD|EXD
EXG|EXG
EXI|EXI
EXK|EXK
EXN|EXN
EXP|EXP
EXPR|EXPR
EXR|EXR
EYLD|EYLD
EZA|EZA
EZJ|EZJ
EZM|EZM
EZU|EZU
F|F
FpB|F-B
FpC|F-C
FpD|F-D
FACA|FACA
FACA.U|FACA=
FACA.WS|FACA+
FACT|FACT
FACT.U|FACT=
FACT.WS|FACT+
FAF|FAF
FAIL|FAIL
FAM|FAM
FAN|FAN
FAPR|FAPR
FAS|FAS
FATH|FATH
FATH.WS|FATH+
FAUG|FAUG
FAX|FAX
FAZ|FAZ
FBCG|FBCG
FBCV|FBCV
FBGX|FBGX
FBHS|FBHS
FBK|FBK
FBND|FBND
FBP|FBP
FBRT|FBRT
FBRTpE|FBRT-E
FBT|FBT
FC|FC
FCAX|FCAX
FCAX.U|FCAX=
FCAX.WS|FCAX+
FCF|FCF
FCG|FCG
FCLD|FCLD
FCN|FCN
FCO|FCO
FCOM|FCOM
FCOR|FCOR
FCPI|FCPI
FCPT|FCPT
FCRX|FCRX
FCSH|FCSH
FCT|FCT
FCTR|FCTR
FCX|FCX
FDD|FDD
FDEC|FDEC
FDEM|FDEM
FDEU|FDEU
FDEV|FDEV
FDG|FDG
FDHT|FDHT
FDHY|FDHY
FDIS|FDIS
FDL|FDL
FDLO|FDLO
FDLS|FDLS
FDM|FDM
FDMO|FDMO
FDN|FDN
FDP|FDP
FDRR|FDRR
FDRV|FDRV
FDS|FDS
FDV|FDV
FDVV|FDVV
FDWM|FDWM
FDX|FDX
FE|FE
FEBZ|FEBZ
FEDL|FEDL
FEDM|FEDM
FEDU|FEDU
FEEM|FEEM
FEHY|FEHY
FEI|FEI
FEIG|FEIG
FEN|FEN
FENG|FENG
FENY|FENY
FERG|FERG
FET|FET
FEUS|FEUS
FEZ|FEZ
FF|FF
FFA|FFA
FFC|FFC
FFEB|FFEB
FFHG|FFHG
FFIU|FFIU
FFND|FFND
FFSG|FFSG
FFTG|FFTG
FFTI|FFTI
FFTY|FFTY
FG|FG
FGB|FGB
FGD|FGD
FGLD|FGLD
FGRO|FGRO
FHI|FHI
FHLC|FHLC
FHN|FHN
FHNpB|FHN-B
FHNpC|FHN-C
FHNpD|FHN-D
FHNpE|FHN-E
FHNpF|FHN-F
FHYS|FHYS
FIAX|FIAX
FIBR|FIBR
FICO|FICO
FIDI|FIDI
FIDU|FIDU
FIEE|FIEE
FIF|FIF
FIG|FIG
FIGB|FIGB
FIGS|FIGS
FIHD|FIHD
FILL|FILL
FINS|FINS
FINV|FINV
FIS|FIS
FISK|FISK
FISR|FISR
FITE|FITE
FIVA|FIVA
FIVG|FIVG
FIW|FIW
FIX|FIX
FJAN|FJAN
FJUL|FJUL
FJUN|FJUN
FL|FL
FLAG|FLAG
FLAG.U|FLAG=
FLAG.WS|FLAG+
FLAU|FLAU
FLAX|FLAX
FLBL|FLBL
FLBR|FLBR
FLC|FLC
FLCA|FLCA
FLCB|FLCB
FLCH|FLCH
FLCO|FLCO
FLDR|FLDR
FLDZ|FLDZ
FLEE|FLEE
FLEH|FLEH
FLFR|FLFR
FLGB|FLGB
FLGR|FLGR
FLGV|FLGV
FLHK|FLHK
FLHY|FLHY
FLIA|FLIA
FLIN|FLIN
FLIY|FLIY
FLJH|FLJH
FLJP|FLJP
FLKR|FLKR
FLLA|FLLA
FLLV|FLLV
FLMB|FLMB
FLME|FLME
FLME.U|FLME=
FLME.WS|FLME+
FLMI|FLMI
FLMX|FLMX
FLNG|FLNG
FLO|FLO
FLOT|FLOT
FLQL|FLQL
FLQM|FLQM
FLQS|FLQS
FLR|FLR
FLRG|FLRG
FLRN|FLRN
FLRT|FLRT
FLRU|FLRU
FLS|FLS
FLSA|FLSA
FLSP|FLSP
FLSW|FLSW
FLT|FLT
FLTB|FLTB
FLTN|FLTN
FLTR|FLTR
FLTW|FLTW
FLUD|FLUD
FLV|FLV
FLYA|FLYA
FLYA.U|FLYA=
FLYA.WS|FLYA+
FLYD|FLYD
FLYU|FLYU
FLZA|FLZA
FM|FM
FMAG|FMAG
FMAR|FMAR
FMAT|FMAT
FMAY|FMAY
FMC|FMC
FMCX|FMCX
FMF|FMF
FMIL|FMIL
FMN|FMN
FMNY|FMNY
FMQQ|FMQQ
FMS|FMS
FMX|FMX
FMY|FMY
FN|FN
FNA|FNA
FNB|FNB
FNBpE|FNB-E
FNCL|FNCL
FND|FND
FNDA|FNDA
FNDB|FNDB
FNDC|FNDC
FNDE|FNDE
FNDF|FNDF
FNDX|FNDX
FNF|FNF
FNGD|FNGD
FNGG|FNGG
FNGO|FNGO
FNGS|FNGS
FNGU|FNGU
FNI|FNI
FNOV|FNOV
FNTC|FNTC
FNV|FNV
FOA|FOA
FOA.WS|FOA+
FOCT|FOCT
FOF|FOF
FOMO|FOMO
FOR|FOR
FORG|FORG
FORH|FORH
FOUR|FOUR
FOVL|FOVL
FOXO|FOXO
FOXO.WS|FOXO+
FPAC|FPAC
FPAC.U|FPAC=
FPAC.WS|FPAC+
FPAG|FPAG
FPE|FPE
FPEI|FPEI
FPF|FPF
FPFD|FPFD
FPH|FPH
FPI|FPI
FPL|FPL
FPRO|FPRO
FPX|FPX
FQAL|FQAL
FR|FR
FRA|FRA
FRC|FRC
FRCpH|FRC-H
FRCpI|FRC-I
FRCpJ|FRC-J
FRCpK|FRC-K
FRCpL|FRC-L
FRCpM|FRC-M
FRCpN|FRC-N
FRD|FRD
FRDM|FRDM
FREL|FREL
FREY|FREY
FREY.WS|FREY+
FRGE|FRGE
FRI|FRI
FRNW|FRNW
FRO|FRO
FRT|FRT
FRTpC|FRT-C
FRTY|FRTY
FRXB|FRXB
FRXB.U|FRXB=
FRXB.WS|FRXB+
FSBD|FSBD
FSCO|FSCO
FSD|FSD
FSEC|FSEC
FSEP|FSEP
FSI|FSI
FSIG|FSIG
FSK|FSK
FSLD|FSLD
FSLY|FSLY
FSM|FSM
FSMB|FSMB
FSMD|FSMD
FSMO|FSMO
FSNB|FSNB
FSNB.U|FSNB=
FSP|FSP
FSR|FSR
FSS|FSS
FSST|FSST
FSTA|FSTA
FSYD|FSYD
FT|FT
FTCH|FTCH
FTEC|FTEC
FTEV|FTEV
FTEV.U|FTEV=
FTEV.WS|FTEV+
FTF|FTF
FTHY|FTHY
FTI|FTI
FTK|FTK
FTLS|FTLS
FTS|FTS
FTSD|FTSD
FTV|FTV
FUBO|FUBO
FUE|FUE
FUL|FUL
FUMB|FUMB
FUN|FUN
FUNL|FUNL
FURY|FURY
FUTY|FUTY
FVAL|FVAL
FVD|FVD
FVRR|FVRR
FXA|FXA
FXB|FXB
FXC|FXC
FXD|FXD
FXE|FXE
FXF|FXF
FXG|FXG
FXH|FXH
FXI|FXI
FXL|FXL
FXLV|FXLV
FXN|FXN
FXO|FXO
FXP|FXP
FXR|FXR
FXU|FXU
FXY|FXY
FXZ|FXZ
FYLD|FYLD
FYLG|FYLG
FZT|FZT
FZT.U|FZT=
FZT.WS|FZT+
G|G
GAA|GAA
GAB|GAB
GABpG|GAB-G
GABpH|GAB-H
GABpK|GAB-K
GABF|GABF
GAL|GAL
GAM|GAM
GAMpB|GAM-B
GAMR|GAMR
GAQ|GAQ
GAQ.U|GAQ=
GAQ.WS|GAQ+
GAST|GAST
GATO|GATO
GATX|GATX
GAU|GAU
GAZ|GAZ
GB|GB
GB.WS|GB+
GBAB|GBAB
GBCI|GBCI
GBF|GBF
GBIL|GBIL
GBLD|GBLD
GBLI|GBLI
GBR|GBR
GBTG|GBTG
GBUG|GBUG
GBUY|GBUY
GBX|GBX
GCC|GCC
GCI|GCI
GCLN|GCLN
GCO|GCO
GCOR|GCOR
GCOW|GCOW
GCV|GCV
GD|GD
GDDY|GDDY
GDE|GDE
GDIV|GDIV
GDL|GDL
GDLpC|GDL-C
GDMA|GDMA
GDMN|GDMN
GDO|GDO
GDOC|GDOC
GDOT|GDOT
GDV|GDV
GDVpH|GDV-H
GDVpK|GDV-K
GDVD|GDVD
GDX|GDX
GDXD|GDXD
GDXJ|GDXJ
GDXU|GDXU
GE|GE
GEF|GEF
GEF.B|GEF.B
GEHI|GEHI
GEL|GEL
GEM|GEM
GEMD|GEMD
GENC|GENC
GENI|GENI
GENI.WS|GENI+
GEO|GEO
GER|GER
GERM|GERM
GES|GES
GETY|GETY
GF|GF
GFF|GFF
GFI|GFI
GFL|GFL
GFLU|GFLU
GFOF|GFOF
GFOR|GFOR
GFOR.U|GFOR=
GFOR.WS|GFOR+
GFX|GFX
GFX.U|GFX=
GFX.WS|GFX+
GGB|GGB
GGG|GGG
GGN|GGN
GGNpB|GGN-B
GGRW|GGRW
GGT|GGT
GGTpE|GGT-E
GGTpG|GGT-G
GGZ|GGZ
GHC|GHC
GHG|GHG
GHL|GHL
GHLD|GHLD
GHM|GHM
GHTA|GHTA
GHY|GHY
GHYB|GHYB
GHYG|GHYG
GIA|GIA
GIA.U|GIA=
GIA.WS|GIA+
GIB|GIB
GIC|GIC
GIGB|GIGB
GII|GII
GIL|GIL
GIM|GIM
GINN|GINN
GIS|GIS
GJH|GJH
GJO|GJO
GJP|GJP
GJR|GJR
GJS|GJS
GJT|GJT
GK|GK
GKOS|GKOS
GL|GL
GLpD|GL-D
GLCN|GLCN
GLD|GLD
GLDB|GLDB
GLDG|GLDG
GLDM|GLDM
GLDX|GLDX
GLIF|GLIF
GLIN|GLIN
GLL|GLL
GLO|GLO
GLOB|GLOB
GLOGpA|GLOG-A
GLOP|GLOP
GLOPpA|GLOP-A
GLOPpB|GLOP-B
GLOPpC|GLOP-C
GLOV|GLOV
GLP|GLP
GLPpA|GLP-A
GLPpB|GLP-B
GLQ|GLQ
GLRY|GLRY
GLS|GLS
GLS.WS|GLS+
GLT|GLT
GLTA|GLTA
GLTA.U|GLTA=
GLTA.WS|GLTA+
GLTR|GLTR
GLU|GLU
GLUpA|GLU-A
GLUpB|GLU-B
GLV|GLV
GLW|GLW
GM|GM
GME|GME
GMED|GMED
GMET|GMET
GMF|GMF
GMOM|GMOM
GMRE|GMRE
GMREpA|GMRE-A
GMS|GMS
GNE|GNE
GNEpA|GNE-A
GNK|GNK
GNL|GNL
GNLpA|GNL-A
GNLpB|GNL-B
GNR|GNR
GNRC|GNRC
GNS|GNS
GNT|GNT
GNTpA|GNT-A
GNW|GNW
GOAU|GOAU
GOEX|GOEX
GOF|GOF
GOGN|GOGN
GOGN.U|GOGN=
GOGN.WS|GOGN+
GOL|GOL
GOLD|GOLD
GOLF|GOLF
GOOS|GOOS
GORO|GORO
GOTU|GOTU
GOVT|GOVT
GOVZ|GOVZ
GPAL|GPAL
GPC|GPC
GPI|GPI
GPJA|GPJA
GPK|GPK
GPMT|GPMT
GPMTpA|GPMT-A
GPN|GPN
GPOR|GPOR
GPRK|GPRK
GPS|GPS
GQRE|GQRE
GRBK|GRBK
GRBKpA|GRBK-A
GRC|GRC
GREI|GREI
GREK|GREK
GRES|GRES
GRF|GRF
GRFX|GRFX
GRMN|GRMN
GRN|GRN
GRNB|GRNB
GRND|GRND
GRND.WS|GRND+
GRNT|GRNT
GRNT.WS|GRNT+
GROV|GROV
GROV.WS|GROV+
GROY|GROY
GROY.WS|GROY+
GRP.U|GRP=
GRU|GRU
GRX|GRX
GRZZ|GRZZ
GS|GS
GSpA|GS-A
GSpC|GS-C
GSpD|GS-D
GSpJ|GS-J
GSpK|GS-K
GSAT|GSAT
GSBD|GSBD
GSEE|GSEE
GSEU|GSEU
GSEW|GSEW
GSFP|GSFP
GSG|GSG
GSID|GSID
GSIE|GSIE
GSIG|GSIG
GSJY|GSJY
GSK|GSK
GSL|GSL
GSLpB|GSL-B
GSLC|GSLC
GSP|GSP
GSPY|GSPY
GSQB|GSQB
GSQB.U|GSQB=
GSQB.WS|GSQB+
GSQD|GSQD
GSQD.U|GSQD=
GSSC|GSSC
GSST|GSST
GSUS|GSUS
GSY|GSY
GTE|GTE
GTEK|GTEK
GTES|GTES
GTIP|GTIP
GTLS|GTLS
GTN|GTN
GTN.A|GTN.A
GTO|GTO
GTY|GTY
GUG|GUG
GUNR|GUNR
GURU|GURU
GUSA|GUSA
GUSH|GUSH
GUT|GUT
GUTpC|GUT-C
GVA|GVA
GVAL|GVAL
GVI|GVI
GVIP|GVIP
GVLU|GVLU
GWH|GWH
GWH.WS|GWH+
GWRE|GWRE
GWW|GWW
GWX|GWX
GXC|GXC
GXG|GXG
GXO|GXO
GYLD|GYLD
H|H
HACK|HACK
HAE|HAE
HAIL|HAIL
HAL|HAL
HAP|HAP
HAPI|HAPI
HAPY|HAPY
HART|HART
HASI|HASI
HAUS|HAUS
HAUZ|HAUZ
HAWX|HAWX
HAYW|HAYW
HBB|HBB
HBI|HBI
HBM|HBM
HCA|HCA
HCC|HCC
HCI|HCI
HCOM|HCOM
HCRB|HCRB
HCXY|HCXY
HD|HD
HDAW|HDAW
HDB|HDB
HDEF|HDEF
HDG|HDG
HDGE|HDGE
HDIV|HDIV
HDLB|HDLB
HDMV|HDMV
HDRO|HDRO
HDUS|HDUS
HDV|HDV
HE|HE
HEDJ|HEDJ
HEEM|HEEM
HEET|HEET
HEFA|HEFA
HEGD|HEGD
HEI|HEI
HEI.A|HEI.A
HELX|HELX
HEP|HEP
HEQ|HEQ
HEQT|HEQT
HES|HES
HESM|HESM
HEWC|HEWC
HEWJ|HEWJ
HEWU|HEWU
HEZU|HEZU
HFGO|HFGO
HFND|HFND
HFRO|HFRO
HFROpA|HFRO-A
HFXI|HFXI
HGER|HGER
HGLB|HGLB
HGTY|HGTY
HGTY.WS|HGTY+
HGV|HGV
HHC|HHC
HHLA|HHLA
HHLA.U|HHLA=
HHLA.WS|HHLA+
HI|HI
HIBL|HIBL
HIBS|HIBS
HIDE|HIDE
HIE|HIE
HIG|HIG
HIGpG|HIG-G
HIGH|HIGH
HII|HII
HIL|HIL
HIMS|HIMS
HIO|HIO
HIPO|HIPO
HIPO.WS|HIPO+
HIPS|HIPS
HIW|HIW
HIX|HIX
HJEN|HJEN
HKD|HKD
HKND|HKND
HL|HL
HLpB|HL-B
HLF|HLF
HLGE|HLGE
HLGN|HLGN
HLGN.WS|HLGN+
HLI|HLI
HLIO|HLIO
HLLY|HLLY
HLLY.WS|HLLY+
HLN|HLN
HLT|HLT
HLX|HLX
HMA|HMA
HMA.U|HMA=
HMA.WS|HMA+
HMC|HMC
HMLPpA|HMLP-A
HMN|HMN
HMOP|HMOP
HMY|HMY
HNI|HNI
HNRA|HNRA
HNRA.WS|HNRA+
HNW|HNW
HOG|HOG
HOLD|HOLD
HOM|HOM
HOMB|HOMB
HOMZ|HOMZ
HOTL|HOTL
HOUS|HOUS
HOV|HOV
HP|HP
HPE|HPE
HPF|HPF
HPI|HPI
HPP|HPP
HPPpC|HPP-C
HPQ|HPQ
HPS|HPS
HPX|HPX
HPX.U|HPX=
HPX.WS|HPX+
HQH|HQH
HQL|HQL
HR|HR
HRB|HRB
HRI|HRI
HRL|HRL
HRT|HRT
HRTG|HRTG
HSBC|HSBC
HSC|HSC
HSCZ|HSCZ
HSMV|HSMV
HSRT|HSRT
HSUN|HSUN
HSY|HSY
HT|HT
HTpC|HT-C
HTpD|HT-D
HTpE|HT-E
HTAB|HTAB
HTD|HTD
HTEC|HTEC
HTFB|HTFB
HTFC|HTFC
HTGC|HTGC
HTH|HTH
HTPA|HTPA
HTPA.U|HTPA=
HTRB|HTRB
HTUS|HTUS
HTY|HTY
HUBB|HUBB
HUBS|HUBS
HUGS|HUGS
HUGS.U|HUGS=
HUM|HUM
HUN|HUN
HUSA|HUSA
HUSV|HUSV
HUYA|HUYA
HVAL|HVAL
HVT|HVT
HVT.A|HVT.A
HWKZ|HWKZ
HWKZ.U|HWKZ=
HWM|HWM
HWMp|HWM-
HXL|HXL
HY|HY
HYB|HYB
HYBB|HYBB
HYBL|HYBL
HYD|HYD
HYDB|HYDB
HYDW|HYDW
HYEM|HYEM
HYG|HYG
HYGH|HYGH
HYGI|HYGI
HYGV|HYGV
HYGW|HYGW
HYHG|HYHG
HYI|HYI
HYIN|HYIN
HYLB|HYLB
HYLD|HYLD
HYLG|HYLG
HYLN|HYLN
HYLV|HYLV
HYMB|HYMB
HYMU|HYMU
HYRM|HYRM
HYS|HYS
HYT|HYT
HYTR|HYTR
HYUP|HYUP
HYXU|HYXU
HZN|HZN
HZO|HZO
HZON|HZON
HZON.U|HZON=
HZON.WS|HZON+
IAA|IAA
IAE|IAE
IAF|IAF
IAG|IAG
IAGG|IAGG
IAI|IAI
IAK|IAK
IAPR|IAPR
IAT|IAT
IAU|IAU
IAUF|IAUF
IAUM|IAUM
IAUX|IAUX
IBA|IBA
IBCE|IBCE
IBD|IBD
IBDD|IBDD
IBDN|IBDN
IBDO|IBDO
IBDP|IBDP
IBDQ|IBDQ
IBDR|IBDR
IBDS|IBDS
IBDT|IBDT
IBDU|IBDU
IBDV|IBDV
IBDW|IBDW
IBDX|IBDX
IBER|IBER
IBER.U|IBER=
IBER.WS|IBER+
IBHB|IBHB
IBHC|IBHC
IBHD|IBHD
IBHE|IBHE
IBHF|IBHF
IBHG|IBHG
IBHH|IBHH
IBHI|IBHI
IBIO|IBIO
IBLC|IBLC
IBM|IBM
IBML|IBML
IBMM|IBMM
IBMN|IBMN
IBMO|IBMO
IBMP|IBMP
IBMQ|IBMQ
IBN|IBN
IBND|IBND
IBO|IBO
IBP|IBP
IBRN|IBRN
IBUY|IBUY
ICAP|ICAP
ICD|ICD
ICE|ICE
ICF|ICF
ICL|ICL
ICNC|ICNC
ICNC.U|ICNC=
ICNC.WS|ICNC+
ICOW|ICOW
ICRpA|ICR-A
ICSH|ICSH
ICVT|ICVT
ID|ID
IDA|IDA
IDAT|IDAT
IDE|IDE
IDEV|IDEV
IDHD|IDHD
IDHQ|IDHQ
IDIV|IDIV
IDLV|IDLV
IDME|IDME
IDMO|IDMO
IDNA|IDNA
IDOG|IDOG
IDR|IDR
IDRV|IDRV
IDT|IDT
IDU|IDU
IDV|IDV
IDVO|IDVO
IDW|IDW
IDX|IDX
IE|IE
IEDI|IEDI
IEFA|IEFA
IEMG|IEMG
IEO|IEO
IETC|IETC
IEUR|IEUR
IEV|IEV
IEX|IEX
IEZ|IEZ
IFED|IFED
IFF|IFF
IFIN|IFIN
IFIN.U|IFIN=
IFIN.WS|IFIN+
IFN|IFN
IFRA|IFRA
IFS|IFS
IG|IG
IGA|IGA
IGBH|IGBH
IGC|IGC
IGD|IGD
IGE|IGE
IGEB|IGEB
IGHG|IGHG
IGI|IGI
IGLB|IGLB
IGLD|IGLD
IGM|IGM
IGN|IGN
IGR|IGR
IGRO|IGRO
IGT|IGT
IGTR|IGTR
IGV|IGV
IGZ|IGZ
IH|IH
IHAK|IHAK
IHD|IHD
IHDG|IHDG
IHE|IHE
IHF|IHF
IHG|IHG
IHI|IHI
IHIT|IHIT
IHS|IHS
IHT|IHT
IHTA|IHTA
IHY|IHY
IIF|IIF
IIGD|IIGD
IIGV|IIGV
IIIN|IIIN
IIM|IIM
IIPR|IIPR
IIPRpA|IIPR-A
IJAN|IJAN
IJH|IJH
IJJ|IJJ
IJK|IJK
IJR|IJR
IJS|IJS
IJUL|IJUL
ILCB|ILCB
ILCG|ILCG
ILCV|ILCV
ILDR|ILDR
ILF|ILF
ILTB|ILTB
IMAX|IMAX
IMCB|IMCB
IMCG|IMCG
IMFL|IMFL
IMH|IMH
IMLP|IMLP
IMO|IMO
IMOM|IMOM
IMTB|IMTB
IMTM|IMTM
INAQ|INAQ
INAQ.U|INAQ=
INAQ.WS|INAQ+
INC|INC
INCO|INCO
INDA|INDA
INDF|INDF
INDL|INDL
INDO|INDO
INDS|INDS
INFA|INFA
INFL|INFL
INFU|INFU
INFY|INFY
ING|ING
INGR|INGR
INKM|INKM
INLX|INLX
INMU|INMU
INN|INN
INNpE|INN-E
INNpF|INN-F
INNO|INNO
INQQ|INQQ
INSI|INSI
INSP|INSP
INST|INST
INSW|INSW
INT|INT
INTF|INTF
INTL|INTL
INTT|INTT
INUV|INUV
INVH|INVH
IOCT|IOCT
ION|ION
IONQ|IONQ
IONQ.WS|IONQ+
IOO|IOO
IOR|IOR
IOT|IOT
IP|IP
IPAC|IPAC
IPAY|IPAY
IPB|IPB
IPDP|IPDP
IPG|IPG
IPI|IPI
IPO|IPO
IPOS|IPOS
IPPP|IPPP
IPVA|IPVA
IPVA.U|IPVA=
IPVA.WS|IPVA+
IPVF|IPVF
IPVF.U|IPVF=
IPVF.WS|IPVF+
IQDE|IQDE
IQDF|IQDF
IQDG|IQDG
IQDY|IQDY
IQHI|IQHI
IQI|IQI
IQIN|IQIN
IQLT|IQLT
IQM|IQM
IQSI|IQSI
IQSM|IQSM
IQSU|IQSU
IQV|IQV
IR|IR
IRBA|IRBA
IRBO|IRBO
IRL|IRL
IRM|IRM
IRNT|IRNT
IRNT.WS|IRNT+
IRRX|IRRX
IRRX.U|IRRX=
IRRX.WS|IRRX+
IRS|IRS
IRS.WS|IRS+
IRT|IRT
IRVH|IRVH
ISCB|ISCB
ISCF|ISCF
ISCG|ISCG
ISCV|ISCV
ISD|ISD
ISDR|ISDR
ISMD|ISMD
ISR|ISR
ISRA|ISRA
ISVL|ISVL
ISWN|ISWN
ISZE|ISZE
IT|IT
ITA|ITA
ITAN|ITAN
ITB|ITB
ITCB|ITCB
ITEQ|ITEQ
ITGR|ITGR
ITM|ITM
ITOT|ITOT
ITP|ITP
ITRG|ITRG
ITT|ITT
ITUB|ITUB
ITW|ITW
IUSA|IUSA
IVAL|IVAL
IVC|IVC
IVDG|IVDG
IVE|IVE
IVES|IVES
IVH|IVH
IVLC|IVLC
IVLU|IVLU
IVOG|IVOG
IVOL|IVOL
IVOO|IVOO
IVOV|IVOV
IVR|IVR
IVRpB|IVR-B
IVRpC|IVR-C
IVRA|IVRA
IVSG|IVSG
IVT|IVT
IVV|IVV
IVW|IVW
IVZ|IVZ
IWB|IWB
IWC|IWC
IWD|IWD
IWDL|IWDL
IWF|IWF
IWFG|IWFG
IWFH|IWFH
IWFL|IWFL
IWIN|IWIN
IWL|IWL
IWLG|IWLG
IWM|IWM
IWML|IWML
IWN|IWN
IWO|IWO
IWP|IWP
IWR|IWR
IWS|IWS
IWV|IWV
IWX|IWX
IWY|IWY
IX|IX
IXC|IXC
IXG|IXG
IXJ|IXJ
IXN|IXN
IXP|IXP
IXSE|IXSE
IYC|IYC
IYE|IYE
IYF|IYF
IYG|IYG
IYH|IYH
IYJ|IYJ
IYK|IYK
IYLD|IYLD
IYM|IYM
IYR|IYR
IYT|IYT
IYW|IYW
IYY|IYY
IYZ|IYZ
IZRL|IZRL
J|J
JAAA|JAAA
JAGG|JAGG
JANT|JANT
JANW|JANW
JANZ|JANZ
JATT|JATT
JATT.U|JATT=
JATT.WS|JATT+
JAVA|JAVA
JBBB|JBBB
JBGS|JBGS
JBI|JBI
JBK|JBK
JBL|JBL
JBT|JBT
JCE|JCE
JCI|JCI
JCPB|JCPB
JCPI|JCPI
JCTR|JCTR
JDST|JDST
JEF|JEF
JELD|JELD
JEMA|JEMA
JEPI|JEPI
JEQ|JEQ
JETS|JETS
JFR|JFR
JFWD|JFWD
JGH|JGH
JGRO|JGRO
JHAA|JHAA
JHCB|JHCB
JHDV|JHDV
JHEM|JHEM
JHG|JHG
JHI|JHI
JHMB|JHMB
JHMD|JHMD
JHML|JHML
JHMM|JHMM
JHPI|JHPI
JHS|JHS
JHSC|JHSC
JHX|JHX
JIB|JIB
JIDA|JIDA
JIG|JIG
JIGB|JIGB
JILL|JILL
JIRE|JIRE
JJA|JJA
JJC|JJC
JJE|JJE
JJG|JJG
JJM|JJM
JJN|JJN
JJP|JJP
JJS|JJS
JJT|JJT
JJU|JJU
JKS|JKS
JLL|JLL
JLS|JLS
JMBS|JMBS
JMEE|JMEE
JMIA|JMIA
JMM|JMM
JMOM|JMOM
JMST|JMST
JMUB|JMUB
JNJ|JNJ
JNK|JNK
JNPR|JNPR
JNUG|JNUG
JO|JO
JOB|JOB
JOBY|JOBY
JOBY.WS|JOBY+
JOE|JOE
JOF|JOF
JOJO|JOJO
JPC|JPC
JPEM|JPEM
JPHY|JPHY
JPI|JPI
JPIB|JPIB
JPIE|JPIE
JPIN|JPIN
JPM|JPM
JPMpC|JPM-C
JPMpD|JPM-D
JPMpJ|JPM-J
JPMpK|JPM-K
JPMpL|JPM-L
JPMpM|JPM-M
JPMB|JPMB
JPME|JPME
JPRE|JPRE
JPS|JPS
JPSE|JPSE
JPST|JPST
JPT|JPT
JPUS|JPUS
JPXN|JPXN
JQC|JQC
JQUA|JQUA
JRE|JRE
JRI|JRI
JRNY|JRNY
JRO|JRO
JRS|JRS
JSCP|JSCP
JSD|JSD
JSTC|JSTC
JT|JT
JUCY|JUCY
JULT|JULT
JULW|JULW
JULZ|JULZ
JUN|JUN
JUN.U|JUN=
JUN.WS|JUN+
JUNZ|JUNZ
JUSA|JUSA
JUST|JUST
JVAL|JVAL
JWN|JWN
JWSM|JWSM
JWSM.U|JWSM=
JWSM.WS|JWSM+
JXI|JXI
JXN|JXN
JZRO|JZRO
K|K
KAHC|KAHC
KAHC.U|KAHC=
KAHC.WS|KAHC+
KAI|KAI
KALL|KALL
KAMN|KAMN
KAPR|KAPR
KAR|KAR
KARB|KARB
KARS|KARS
KB|KB
KBA|KBA
KBE|KBE
KBH|KBH
KBND|KBND
KBR|KBR
KBUY|KBUY
KCCA|KCCA
KCE|KCE
KCGI|KCGI
KCGI.U|KCGI=
KCGI.WS|KCGI+
KD|KD
KDIV|KDIV
KDRN|KDRN
KEMQ|KEMQ
KEMX|KEMX
KEN|KEN
KEP|KEP
KESG|KESG
KEUA|KEUA
KEX|KEX
KEY|KEY
KEYpI|KEY-I
KEYpJ|KEY-J
KEYpK|KEY-K
KEYpL|KEY-L
KEYS|KEYS
KF|KF
KFS|KFS
KFVG|KFVG
KFY|KFY
KFYP|KFYP
KGC|KGC
KGHG|KGHG
KGRN|KGRN
KGRO|KGRO
KHYB|KHYB
KIE|KIE
KIM|KIM
KIMpL|KIM-L
KIMpM|KIM-M
KIND|KIND
KIO|KIO
KIQ|KIQ
KJAN|KJAN
KJUL|KJUL
KKR|KKR
KKRpC|KKR-C
KKRS|KKRS
KLCD|KLCD
KLDW|KLDW
KLNE|KLNE
KLR|KLR
KLR.WS|KLR+
KMB|KMB
KMED|KMED
KMET|KMET
KMF|KMF
KMI|KMI
KMLM|KMLM
KMPB|KMPB
KMPR|KMPR
KMT|KMT
KMX|KMX
KN|KN
KNG|KNG
KNGS|KNGS
KNOP|KNOP
KNSL|KNSL
KNSW|KNSW
KNSW.U|KNSW=
KNSW.WS|KNSW+
KNTK|KNTK
KNW|KNW
KNX|KNX
KO|KO
KOCG|KOCG
KOCT|KOCT
KODK|KODK
KOF|KOF
KOIN|KOIN
KOKU|KOKU
KOLD|KOLD
KOMP|KOMP
KONG|KONG
KOP|KOP
KORE|KORE
KORE.WS|KORE+
KORP|KORP
KORU|KORU
KOS|KOS
KPOP|KPOP
KR|KR
KRBN|KRBN
KRC|KRC
KRE|KRE
KREF|KREF
KREFpA|KREF-A
KRG|KRG
KRO|KRO
KRP|KRP
KSA|KSA
KSCD|KSCD
KSET|KSET
KSM|KSM
KSS|KSS
KSTR|KSTR
KT|KT
KTB|KTB
KTEC|KTEC
KTF|KTF
KTH|KTH
KTN|KTN
KUKE|KUKE
KULR|KULR
KURE|KURE
KVLE|KVLE
KW|KW
KWEB|KWEB
KWR|KWR
KWT|KWT
KXI|KXI
KYN|KYN
L|L
LABD|LABD
LABU|LABU
LAC|LAC
LAD|LAD
LADR|LADR
LAW|LAW
LAZ|LAZ
LBAY|LBAY
LBRT|LBRT
LC|LC
LCF|LCF
LCG|LCG
LCI|LCI
LCII|LCII
LCLG|LCLG
LCR|LCR
LCTD|LCTD
LCTU|LCTU
LCTX|LCTX
LCW|LCW
LCW.U|LCW=
LCW.WS|LCW+
LD|LD
LDI|LDI
LDOS|LDOS
LDP|LDP
LDUR|LDUR
LEA|LEA
LEAD|LEAD
LEG|LEG
LEJU|LEJU
LEMB|LEMB
LEN|LEN
LEN.B|LEN.B
LEO|LEO
LETB|LETB
LEU|LEU
LEV|LEV
LEV.WS|LEV+
LEVI|LEVI
LEXI|LEXI
LFEQ|LFEQ
LFG|LFG
LFT|LFT
LFTpA|LFT-A
LGF.A|LGF.A
LGF.B|LGF.B
LGH|LGH
LGI|LGI
LGL|LGL
LGL.WS|LGL+
LGLV|LGLV
LGOV|LGOV
LGV|LGV
LGV.U|LGV=
LGV.WS|LGV+
LH|LH
LHC|LHC
LHC.U|LHC=
LHX|LHX
LICY|LICY
LII|LII
LIN|LIN
LIT|LIT
LITB|LITB
LKOR|LKOR
LL|LL
LLAP|LLAP
LLAP.WS|LLAP+
LLY|LLY
LMND|LMND
LMT|LMT
LNC|LNC
LNCpD|LNC-D
LND|LND
LNG|LNG
LNN|LNN
LOCC|LOCC
LOCC.U|LOCC=
LOCC.WS|LOCC+
LOCL|LOCL
LOCL.WS|LOCL+
LODE|LODE
LOKM|LOKM
LOKM.U|LOKM=
LOKM.WS|LOKM+
LOMA|LOMA
LONZ|LONZ
LOPP|LOPP
LOUP|LOUP
LOW|LOW
LPG|LPG
LPI|LPI
LPL|LPL
LPTV|LPTV
LPX|LPX
LQD|LQD
LQDB|LQDB
LQDH|LQDH
LQDI|LQDI
LQDW|LQDW
LQIG|LQIG
LRGF|LRGF
LRN|LRN
LRNZ|LRNZ
LSAF|LSAF
LSAT|LSAT
LSF|LSF
LSI|LSI
LSPD|LSPD
LSST|LSST
LTC|LTC
LTH|LTH
LTHM|LTHM
LTL|LTL
LTPZ|LTPZ
LU|LU
LUMN|LUMN
LUV|LUV
LVHI|LVHI
LVOL|LVOL
LVS|LVS
LVWR|LVWR
LVWR.WS|LVWR+
LW|LW
LXFR|LXFR
LXP|LXP
LXPpC|LXP-C
LXU|LXU
LYB|LYB
LYFE|LYFE
LYG|LYG
LYV|LYV
LZB|LZB
M|M
MA|MA
MAA|MAA
MAApI|MAA-I
MAAX|MAAX
MAC|MAC
MACC|MACC
MACC.U|MACC=
MAG|MAG
MAGA|MAGA
MAIA|MAIA
MAIN|MAIN
MAKX|MAKX
MAMB|MAMB
MAN|MAN
MANU|MANU
MARB|MARB
MARZ|MARZ
MAS|MAS
MATV|MATV
MATX|MATX
MAV|MAV
MAX|MAX
MAXR|MAXR
MAYZ|MAYZ
MBAC|MBAC
MBAC.U|MBAC=
MBAC.WS|MBAC+
MBBB|MBBB
MBCC|MBCC
MBI|MBI
MBND|MBND
MBNE|MBNE
MBOX|MBOX
MBSC|MBSC
MBSC.U|MBSC=
MBSC.WS|MBSC+
MBSD|MBSD
MC|MC
MCB|MCB
MCD|MCD
MCG|MCG
MCH|MCH
MCI|MCI
MCK|MCK
MCN|MCN
MCO|MCO
MCR|MCR
MCRO|MCRO
MCS|MCS
MCW|MCW
MCY|MCY
MD|MD
MDC|MDC
MDEV|MDEV
MDH|MDH
MDH.U|MDH=
MDT|MDT
MDU|MDU
MDV|MDV
MDVpA|MDV-A
MDY|MDY
MDYG|MDYG
MDYV|MDYV
MEAR|MEAR
MEC|MEC
MED|MED
MEDI|MEDI
MEG|MEG
MEGI|MEGI
MEI|MEI
MEM|MEM
MEME|MEME
MERpK|MER-K
MET|MET
METpA|MET-A
METpE|MET-E
METpF|MET-F
METV|METV
MEXX|MEXX
MFA|MFA
MFApB|MFA-B
MFApC|MFA-C
MFC|MFC
MFD|MFD
MFDX|MFDX
MFEM|MFEM
MFG|MFG
MFGP|MFGP
MFM|MFM
MFUL|MFUL
MFUS|MFUS
MFV|MFV
MG|MG
MGA|MGA
MGC|MGC
MGF|MGF
MGK|MGK
MGLD|MGLD
MGM|MGM
MGMT|MGMT
MGR|MGR
MGRB|MGRB
MGRD|MGRD
MGU|MGU
MGV|MGV
MGY|MGY
MHpA|MH-A
MHpC|MH-C
MHpD|MH-D
MHD|MHD
MHF|MHF
MHH|MHH
MHI|MHI
MHK|MHK
MHLA|MHLA
MHN|MHN
MHNC|MHNC
MHO|MHO
MID|MID
MIDE|MIDE
MIDU|MIDU
MIG|MIG
MIMO|MIMO
MIMO.WS.A|MIMO+A
MIMO.WS.B|MIMO+B
MIMO.WS.C|MIMO+C
MIMO.WS|MIMO+
MIN|MIN
MINC|MINC
MINN|MINN
MINO|MINO
MINT|MINT
MINV|MINV
MIO|MIO
MIR|MIR
MIR.WS|MIR+
MISL|MISL
MIT|MIT
MIT.U|MIT=
MITQ|MITQ
MITT|MITT
MITTpA|MITT-A
MITTpB|MITT-B
MITTpC|MITT-C
MIXT|MIXT
MIY|MIY
MJ|MJ
MJUS|MJUS
MJXL|MJXL
MKC|MKC
MKC.V|MKC.V
MKFG|MKFG
MKFG.WS|MKFG+
MKL|MKL
ML|ML
ML.WS|ML+
MLI|MLI
MLM|MLM
MLN|MLN
MLNK|MLNK
MLP|MLP
MLPA|MLPA
MLPB|MLPB
MLPO|MLPO
MLPR|MLPR
MLPX|MLPX
MLR|MLR
MLSS|MLSS
MMC|MMC
MMCA|MMCA
MMD|MMD
MMI|MMI
MMIN|MMIN
MMIT|MMIT
MMLG|MMLG
MMM|MMM
MMP|MMP
MMS|MMS
MMSB|MMSB
MMSC|MMSC
MMT|MMT
MMTM|MMTM
MMU|MMU
MMX|MMX
MNA|MNA
MNBD|MNBD
MNK|MNK
MNM|MNM
MNP|MNP
MNRL|MNRL
MNSO|MNSO
MNTN|MNTN
MNTN.U|MNTN=
MNTN.WS|MNTN+
MO|MO
MOAT|MOAT
MOD|MOD
MODG|MODG
MODN|MODN
MOG.A|MOG.A
MOG.B|MOG.B
MOGU|MOGU
MOH|MOH
MOHR|MOHR
MOO|MOO
MOOD|MOOD
MOON|MOON
MORT|MORT
MOS|MOS
MOTE|MOTE
MOTG|MOTG
MOTI|MOTI
MOTO|MOTO
MOV|MOV
MP|MP
MPA|MPA
MPAY|MPAY
MPC|MPC
MPLN|MPLN
MPLN.WS|MPLN+
MPLX|MPLX
MPRO|MPRO
MPTI|MPTI
MPV|MPV
MPW|MPW
MPX|MPX
MQT|MQT
MQY|MQY
MRAD|MRAD
MRC|MRC
MRGR|MRGR
MRK|MRK
MRO|MRO
MRSK|MRSK
MS|MS
MSpA|MS-A
MSpE|MS-E
MSpF|MS-F
MSpI|MS-I
MSpK|MS-K
MSpL|MS-L
MSpO|MS-O
MSpP|MS-P
MSA|MSA
MSB|MSB
MSC|MSC
MSCI|MSCI
MSD|MSD
MSGE|MSGE
MSGR|MSGR
MSGS|MSGS
MSI|MSI
MSM|MSM
MSMR|MSMR
MSN|MSN
MSOS|MSOS
MSOX|MSOX
MSTB|MSTB
MSTQ|MSTQ
MSVX|MSVX
MT|MT
MTA|MTA
MTAL|MTAL
MTAL.U|MTAL=
MTAL.WS|MTAL+
MTB|MTB
MTBpH|MTB-H
MTCN|MTCN
MTD|MTD
MTDR|MTDR
MTG|MTG
MTGP|MTGP
MTH|MTH
MTL|MTL
MTLp|MTL-
MTMT|MTMT
MTN|MTN
MTNB|MTNB
MTR|MTR
MTRN|MTRN
MTUL|MTUL
MTUM|MTUM
MTVC|MTVC
MTVC.U|MTVC=
MTVC.WS|MTVC+
MTVR|MTVR
MTW|MTW
MTX|MTX
MTZ|MTZ
MUA|MUA
MUB|MUB
MUC|MUC
MUE|MUE
MUFG|MUFG
MUI|MUI
MUJ|MUJ
MUNI|MUNI
MUR|MUR
MUSA|MUSA
MUSI|MUSI
MUST|MUST
MUX|MUX
MVF|MVF
MVO|MVO
MVPS|MVPS
MVRL|MVRL
MVT|MVT
MVV|MVV
MWA|MWA
MX|MX
MXC|MXC
MXE|MXE
MXF|MXF
MXI|MXI
MYD|MYD
MYE|MYE
MYI|MYI
MYN|MYN
MYO|MYO
MYOV|MYOV
MYTE|MYTE
MYY|MYY
MZZ|MZZ
NABL|NABL
NAC|NAC
NACP|NACP
NAD|NAD
NAIL|NAIL
NAK|NAK
NAN|NAN
NANR|NANR
NAPA|NAPA
NAPR|NAPR
NAT|NAT
NAVB|NAVB
NAZ|NAZ
NBB|NBB
NBCC|NBCC
NBCM|NBCM
NBCT|NBCT
NBDS|NBDS
NBH|NBH
NBHC|NBHC
NBO|NBO
NBR|NBR
NBW|NBW
NBXG|NBXG
NBY|NBY
NC|NC
NCA|NCA
NCLH|NCLH
NCR|NCR
NCV|NCV
NCVpA|NCV-A
NCZ|NCZ
NCZpA|NCZ-A
NDIV|NDIV
NDJI|NDJI
NDMO|NDMO
NDP|NDP
NDVG|NDVG
NE|NE
NEA|NEA
NEAR|NEAR
NEE|NEE
NEEpN|NEE-N
NEEpP|NEE-P
NEEpQ|NEE-Q
NEEpR|NEE-R
NEM|NEM
NEN|NEN
NEP|NEP
NERD|NERD
NET|NET
NETC|NETC
NETC.U|NETC=
NETC.WS|NETC+
NETI|NETI
NETL|NETL
NETZ|NETZ
NEU|NEU
NEWP|NEWP
NEWR|NEWR
NEX|NEX
NEXA|NEXA
NFG|NFG
NFGC|NFGC
NFJ|NFJ
NFLT|NFLT
NFNT|NFNT
NFNT.U|NFNT=
NFNT.WS|NFNT+
NFRA|NFRA
NFTZ|NFTZ
NFYS|NFYS
NFYS.U|NFYS=
NFYS.WS|NFYS+
NG|NG
NGC|NGC
NGC.U|NGC=
NGC.WS|NGC+
NGD|NGD
NGE|NGE
NGG|NGG
NGL|NGL
NGLpB|NGL-B
NGLpC|NGL-C
NGS|NGS
NGVC|NGVC
NGVT|NGVT
NHC|NHC
NHI|NHI
NHS|NHS
NHWK|NHWK
NI|NI
NIpB|NI-B
NIB|NIB
NIC|NIC
NID|NID
NIE|NIE
NILE|NILE
NILEpD|NILE-D
NIM|NIM
NIMC|NIMC
NINE|NINE
NIO|NIO
NIQ|NIQ
NIWM|NIWM
NJAN|NJAN
NJR|NJR
NJUL|NJUL
NKE|NKE
NKG|NKG
NKX|NKX
NL|NL
NLR|NLR
NLS|NLS
NLY|NLY
NLYpF|NLY-F
NLYpG|NLY-G
NLYpI|NLY-I
NM|NM
NMpG|NM-G
NMpH|NM-H
NMAI|NMAI
NMCO|NMCO
NMG|NMG
NMI|NMI
NMKpB|NMK-B
NMKpC|NMK-C
NML|NML
NMM|NMM
NMR|NMR
NMS|NMS
NMT|NMT
NMZ|NMZ
NNI|NNI
NNN|NNN
NNVC|NNVC
NNY|NNY
NOA|NOA
NOAH|NOAH
NOBL|NOBL
NOC|NOC
NOCT|NOCT
NOG|NOG
NOK|NOK
NOM|NOM
NOMD|NOMD
NOPE|NOPE
NORW|NORW
NOTE|NOTE
NOTE.WS|NOTE+
NOV|NOV
NOVA|NOVA
NOVZ|NOVZ
NOW|NOW
NPCT|NPCT
NPFD|NPFD
NPK|NPK
NPO|NPO
NPV|NPV
NQP|NQP
NR|NR
NRDY|NRDY
NRDY.WS|NRDY+
NREF|NREF
NREFpA|NREF-A
NRG|NRG
NRGD|NRGD
NRGU|NRGU
NRGV|NRGV
NRGX|NRGX
NRK|NRK
NRO|NRO
NRP|NRP
NRT|NRT
NRUC|NRUC
NS|NS
NSpA|NS-A
NSpB|NS-B
NSpC|NS-C
NSA|NSA
NSApA|NSA-A
NSC|NSC
NSCS|NSCS
NSL|NSL
NSP|NSP
NSPI|NSPI
NSPL|NSPL
NSPY|NSPY
NSS|NSS
NSTB|NSTB
NSTB.U|NSTB=
NSTB.WS|NSTB+
NSTC|NSTC
NSTC.U|NSTC=
NSTD|NSTD
NSTD.U|NSTD=
NSTD.WS|NSTD+
NTB|NTB
NTCO|NTCO
NTEST|NTEST
NTEST.A|NTEST.A
NTEST.B|NTEST.B
NTEST.C|NTEST.C
NTG|NTG
NTIP|NTIP
NTKI|NTKI
NTR|NTR
NTSE|NTSE
NTSI|NTSI
NTST|NTST
NTSX|NTSX
NTZ|NTZ
NU|NU
NUAG|NUAG
NUBD|NUBD
NUDM|NUDM
NUDV|NUDV
NUE|NUE
NUEM|NUEM
NUGO|NUGO
NUGT|NUGT
NUHY|NUHY
NULC|NULC
NULG|NULG
NULV|NULV
NUMG|NUMG
NUMV|NUMV
NUO|NUO
NURE|NURE
NUS|NUS
NUSA|NUSA
NUSC|NUSC
NUSI|NUSI
NUV|NUV
NUVB|NUVB
NUVB.WS|NUVB+
NUW|NUW
NVBT|NVBT
NVBW|NVBW
NVG|NVG
NVGS|NVGS
NVO|NVO
NVQ|NVQ
NVR|NVR
NVRO|NVRO
NVS|NVS
NVST|NVST
NVT|NVT
NVTA|NVTA
NWG|NWG
NWLG|NWLG
NWN|NWN
NX|NX
NXC|NXC
NXDT|NXDT
NXDTpA|NXDT-A
NXE|NXE
NXG|NXG
NXJ|NXJ
NXN|NXN
NXP|NXP
NXRT|NXRT
NXTE|NXTE
NYC|NYC
NYCB|NYCB
NYCBpA|NYCB-A
NYCBpU|NYCB-U
NYF|NYF
NYT|NYT
NZF|NZF
O|O
OACP|OACP
OAEM|OAEM
OAIE|OAIE
OAIM|OAIM
OAKpA|OAK-A
OAKpB|OAK-B
OALC|OALC
OARK|OARK
OBE|OBE
OBND|OBND
OBOR|OBOR
OC|OC
OCEN|OCEN
OCFT|OCFT
OCIO|OCIO
OCN|OCN
OCTT|OCTT
OCTW|OCTW
OCTZ|OCTZ
ODC|ODC
ODV|ODV
OEC|OEC
OEF|OEF
OEUR|OEUR
OFC|OFC
OFG|OFG
OG|OG
OGCP|OGCP
OGE|OGE
OGEN|OGEN
OGIG|OGIG
OGN|OGN
OGS|OGS
OHI|OHI
OI|OI
OIA|OIA
OIH|OIH
OII|OII
OIL|OIL
OILD|OILD
OILK|OILK
OILU|OILU
OIS|OIS
OKE|OKE
OLN|OLN
OLO|OLO
OLP|OLP
OMC|OMC
OMF|OMF
OMFL|OMFL
OMFS|OMFS
OMI|OMI
OND|OND
ONEO|ONEO
ONEV|ONEV
ONEY|ONEY
ONG|ONG
ONL|ONL
ONLN|ONLN
ONOF|ONOF
ONON|ONON
ONTF|ONTF
ONTO|ONTO
OOMA|OOMA
OOTO|OOTO
OPA|OPA
OPA.U|OPA=
OPA.WS|OPA+
OPAD|OPAD
OPAD.WS|OPAD+
OPER|OPER
OPFI|OPFI
OPFI.WS|OPFI+
OPP|OPP
OPPpA|OPP-A
OPPpB|OPP-B
OPPX|OPPX
OPTT|OPTT
OPY|OPY
OR|OR
ORA|ORA
ORAN|ORAN
ORC|ORC
ORCC|ORCC
ORCL|ORCL
ORFN|ORFN
ORI|ORI
ORLA|ORLA
ORN|ORN
OSCR|OSCR
OSCV|OSCV
OSEA|OSEA
OSG|OSG
OSH|OSH
OSI|OSI
OSI.U|OSI=
OSI.WS|OSI+
OSK|OSK
OTIS|OTIS
OUNZ|OUNZ
OUSA|OUSA
OUSM|OUSM
OUST|OUST
OUST.WS|OUST+
OUT|OUT
OVB|OVB
OVF|OVF
OVL|OVL
OVLH|OVLH
OVM|OVM
OVS|OVS
OVT|OVT
OVV|OVV
OWL|OWL
OWLT|OWLT
OWLT.WS|OWLT+
OWNS|OWNS
OXM|OXM
OXY|OXY
OXY.WS|OXY+
OZ|OZ
PAB|PAB
PAC|PAC
PACI|PACI
PACI.U|PACI=
PACI.WS|PACI+
PACK|PACK
PAG|PAG
PAGS|PAGS
PAI|PAI
PAK|PAK
PALC|PALC
PALL|PALL
PAM|PAM
PAMC|PAMC
PAPR|PAPR
PAR|PAR
PARR|PARR
PATH|PATH
PAUG|PAUG
PAVE|PAVE
PAWZ|PAWZ
PAXS|PAXS
PAY|PAY
PAYC|PAYC
PB|PB
PBA|PBA
PBD|PBD
PBDC|PBDC
PBDM|PBDM
PBE|PBE
PBEE|PBEE
PBF|PBF
PBH|PBH
PBI|PBI
PBIpB|PBI-B
PBJ|PBJ
PBND|PBND
PBP|PBP
PBR|PBR
PBR.A|PBR.A
PBS|PBS
PBSM|PBSM
PBT|PBT
PBTP|PBTP
PBUG|PBUG
PBUS|PBUS
PBW|PBW
PCEF|PCEF
PCF|PCF
PCG|PCG
PCGpA|PCG-A
PCGpB|PCG-B
PCGpC|PCG-C
PCGpD|PCG-D
PCGpE|PCG-E
PCGpG|PCG-G
PCGpH|PCG-H
PCGpI|PCG-I
PCGU|PCGU
PCK|PCK
PCM|PCM
PCN|PCN
PCOR|PCOR
PCPC|PCPC
PCPC.U|PCPC=
PCQ|PCQ
PCY|PCY
PD|PD
PDEC|PDEC
PDI|PDI
PDM|PDM
PDN|PDN
PDO|PDO
PDOT|PDOT
PDOT.U|PDOT=
PDOT.WS|PDOT+
PDS|PDS
PDT|PDT
PEAK|PEAK
PEB|PEB
PEBpE|PEB-E
PEBpF|PEB-F
PEBpG|PEB-G
PEBpH|PEB-H
PED|PED
PEG|PEG
PEI|PEI
PEIpB|PEI-B
PEIpC|PEI-C
PEIpD|PEI-D
PEJ|PEJ
PEN|PEN
PEO|PEO
PERF|PERF
PERF.WS|PERF+
PEX|PEX
PEXL|PEXL
PFD|PFD
PFE|PFE
PFEB|PFEB
PFFA|PFFA
PFFD|PFFD
PFFL|PFFL
PFFR|PFFR
PFFV|PFFV
PFGC|PFGC
PFH|PFH
PFIG|PFIG
PFIX|PFIX
PFL|PFL
PFLD|PFLD
PFLT|PFLT
PFN|PFN
PFO|PFO
PFRL|PFRL
PFS|PFS
PFSI|PFSI
PFUT|PFUT
PFXF|PFXF
PG|PG
PGAL|PGAL
PGF|PGF
PGHY|PGHY
PGM|PGM
PGP|PGP
PGR|PGR
PGRE|PGRE
PGRO|PGRO
PGRU|PGRU
PGSS|PGSS
PGSS.U|PGSS=
PGSS.WS|PGSS+
PGTI|PGTI
PGX|PGX
PGZ|PGZ
PH|PH
PHB|PHB
PHD|PHD
PHDG|PHDG
PHG|PHG
PHGE|PHGE
PHGE.U|PHGE=
PHGE.WS|PHGE+
PHI|PHI
PHK|PHK
PHM|PHM
PHR|PHR
PHT|PHT
PHX|PHX
PHYL|PHYL
PHYS|PHYS
PHYT|PHYT
PHYT.U|PHYT=
PHYT.WS|PHYT+
PIAI|PIAI
PIAI.U|PIAI=
PIAI.WS|PIAI+
PICB|PICB
PICC|PICC
PICC.U|PICC=
PICK|PICK
PIFI|PIFI
PII|PII
PILL|PILL
PIM|PIM
PIN|PIN
PINE|PINE
PINK|PINK
PINS|PINS
PIPR|PIPR
PJAN|PJAN
PJP|PJP
PJT|PJT
PJUL|PJUL
PJUN|PJUN
PK|PK
PKB|PKB
PKE|PKE
PKG|PKG
PKI|PKI
PKX|PKX
PL|PL
PL.WS|PL+
PLAG|PLAG
PLAT|PLAT
PLD|PLD
PLDR|PLDR
PLG|PLG
PLM|PLM
PLNT|PLNT
PLOW|PLOW
PLRG|PLRG
PLTL|PLTL
PLTM|PLTM
PLTR|PLTR
PLX|PLX
PLYM|PLYM
PLYMpA|PLYM-A
PM|PM
PMAR|PMAR
PMAY|PMAY
PMF|PMF
PML|PML
PMM|PMM
PMO|PMO
PMT|PMT
PMTpA|PMT-A
PMTpB|PMT-B
PMTpC|PMT-C
PMX|PMX
PNC|PNC
PNF|PNF
PNI|PNI
PNM|PNM
PNNT|PNNT
PNOV|PNOV
PNR|PNR
PNTM|PNTM
PNTM.U|PNTM=
PNTM.WS|PNTM+
PNW|PNW
POCT|POCT
POL|POL
POL.WS|POL+
POND|POND
POND.U|POND=
POND.WS|POND+
POR|POR
PORT|PORT
PORT.U|PORT=
PORT.WS|PORT+
POST|POST
PP|PP
PPA|PPA
PPG|PPG
PPI|PPI
PPL|PPL
PPLT|PPLT
PPT|PPT
PPTY|PPTY
PQDI|PQDI
PQIN|PQIN
PR|PR
PRA|PRA
PRAY|PRAY
PRBM|PRBM
PRBM.U|PRBM=
PREpJ|PRE-J
PREF|PREF
PRF|PRF
PRG|PRG
PRGO|PRGO
PRH|PRH
PRI|PRI
PRIFpD|PRIF-D
PRIFpF|PRIF-F
PRIFpG|PRIF-G
PRIFpH|PRIF-H
PRIFpI|PRIF-I
PRIFpJ|PRIF-J
PRIFpK|PRIF-K
PRIFpL|PRIF-L
PRK|PRK
PRLB|PRLB
PRM|PRM
PRMW|PRMW
PRNT|PRNT
PRO|PRO
PRPC|PRPC
PRPC.U|PRPC=
PRPC.WS|PRPC+
PRS|PRS
PRT|PRT
PRTY|PRTY
PRU|PRU
PSA|PSA
PSApF|PSA-F
PSApG|PSA-G
PSApH|PSA-H
PSApI|PSA-I
PSApJ|PSA-J
PSApK|PSA-K
PSApL|PSA-L
PSApM|PSA-M
PSApN|PSA-N
PSApO|PSA-O
PSApP|PSA-P
PSApQ|PSA-Q
PSApR|PSA-R
PSApS|PSA-S
PSBpX|PSB-X
PSBpY|PSB-Y
PSBpZ|PSB-Z
PSCJ|PSCJ
PSCQ|PSCQ
PSCW|PSCW
PSCX|PSCX
PSDN|PSDN
PSECpA|PSEC-A
PSEP|PSEP
PSF|PSF
PSFD|PSFD
PSFE|PSFE
PSFE.WS|PSFE+
PSFF|PSFF
PSFJ|PSFJ
PSFM|PSFM
PSFO|PSFO
PSI|PSI
PSIL|PSIL
PSJ|PSJ
PSK|PSK
PSLV|PSLV
PSMB|PSMB
PSMC|PSMC
PSMD|PSMD
PSMG|PSMG
PSMJ|PSMJ
PSMM|PSMM
PSMO|PSMO
PSMR|PSMR
PSN|PSN
PSO|PSO
PSP|PSP
PSPC|PSPC
PSPC.U|PSPC=
PSPC.WS|PSPC+
PSQ|PSQ
PSR|PSR
PST|PST
PSTG|PSTG
PSTL|PSTL
PSTP|PSTP
PSX|PSX
PSYK|PSYK
PTA|PTA
PTBD|PTBD
PTEU|PTEU
PTIN|PTIN
PTLC|PTLC
PTMC|PTMC
PTN|PTN
PTRB|PTRB
PTY|PTY
PUK|PUK
PULS|PULS
PUMP|PUMP
PUNK|PUNK
PUTW|PUTW
PV|PV
PV.U|PV=
PV.WS|PV+
PVAL|PVAL
PVH|PVH
PVI|PVI
PVL|PVL
PW|PW
PWpA|PW-A
PWB|PWB
PWC|PWC
PWR|PWR
PWS|PWS
PWSC|PWSC
PWV|PWV
PWZ|PWZ
PX|PX
PXD|PXD
PXE|PXE
PXF|PXF
PXH|PXH
PXJ|PXJ
PXQ|PXQ
PXUS|PXUS
PYN|PYN
PYPE|PYPE
PYT|PYT
PZA|PZA
PZC|PZC
PZG|PZG
PZT|PZT
QAI|QAI
QARP|QARP
QBTS|QBTS
QBTS.WS|QBTS+
QCON|QCON
QD|QD
QDEC|QDEC
QDEF|QDEF
QDF|QDF
QDIV|QDIV
QDPL|QDPL
QDYN|QDYN
QED|QED
QEFA|QEFA
QEMM|QEMM
QFTA|QFTA
QFTA.U|QFTA=
QGEN|QGEN
QGRO|QGRO
QID|QID
QINT|QINT
QJUN|QJUN
QLC|QLC
QLD|QLD
QLS|QLS
QLTA|QLTA
QLV|QLV
QLVD|QLVD
QLVE|QLVE
QMAR|QMAR
QMN|QMN
QMOM|QMOM
QPFF|QPFF
QPX|QPX
QQH|QQH
QQQE|QQQE
QRFT|QRFT
QS|QS
QSPT|QSPT
QSR|QSR
QSWN|QSWN
QTAP|QTAP
QTJA|QTJA
QTJL|QTJL
QTOC|QTOC
QTUM|QTUM
QTWO|QTWO
QUAD|QUAD
QUAL|QUAL
QULL|QULL
QUOT|QUOT
QUS|QUS
QVAL|QVAL
QVCC|QVCC
QVCD|QVCD
QVML|QVML
QVMM|QVMM
QVMS|QVMS
QWLD|QWLD
R|R
RA|RA
RAAS|RAAS
RAAX|RAAX
RACE|RACE
RAD|RAD
RAFE|RAFE
RAMP|RAMP
RATE|RATE
RAVI|RAVI
RAYC|RAYC
RAYD|RAYD
RAYE|RAYE
RBA|RBA
RBC|RBC
RBCP|RBCP
RBLD|RBLD
RBLX|RBLX
RBND|RBND
RBOT|RBOT
RBOT.WS|RBOT+
RBT|RBT
RBT.WS|RBT+
RC|RC
RCpC|RC-C
RCpE|RC-E
RCA|RCA
RCB|RCB
RCC|RCC
RCD|RCD
RCFA|RCFA
RCFA.U|RCFA=
RCFA.WS|RCFA+
RCG|RCG
RCI|RCI
RCL|RCL
RCS|RCS
RCUS|RCUS
RDFI|RDFI
RDIV|RDIV
RDMX|RDMX
RDN|RDN
RDOG|RDOG
RDVI|RDVI
RDW|RDW
RDW.WS|RDW+
RDY|RDY
RE|RE
RECS|RECS
REET|REET
REGL|REGL
REI|REI
REK|REK
RELX|RELX
REM|REM
REMG|REMG
REMX|REMX
RENN|RENN
RENW|RENW
REPX|REPX
RERE|RERE
RES|RES
RESD|RESD
RESE|RESE
RESI|RESI
RESP|RESP
RETL|RETL
REVG|REVG
REVS|REVS
REW|REW
REX|REX
REXR|REXR
REXRpB|REXR-B
REXRpC|REXR-C
REZ|REZ
REZI|REZI
RF|RF
RFpB|RF-B
RFpC|RF-C
RFpE|RF-E
RFCI|RFCI
RFDA|RFDA
RFFC|RFFC
RFG|RFG
RFI|RFI
RFL|RFL
RFM|RFM
RFMZ|RFMZ
RFP|RFP
RFV|RFV
RGA|RGA
RGI|RGI
RGR|RGR
RGS|RGS
RGT|RGT
RH|RH
RHCB|RHCB
RHE|RHE
RHEpA|RHE-A
RHI|RHI
RHP|RHP
RHRX|RHRX
RHS|RHS
RHTX|RHTX
RIET|RIET
RIG|RIG
RIGS|RIGS
RIGZ|RIGZ
RINF|RINF
RIO|RIO
RISN|RISN
RISR|RISR
RITA|RITA
RITM|RITM
RITMpA|RITM-A
RITMpB|RITM-B
RITMpC|RITM-C
RITMpD|RITM-D
RIV|RIV
RIVpA|RIV-A
RJAC|RJAC
RJAC.U|RJAC=
RJAC.WS|RJAC+
RJF|RJF
RJFpA|RJF-A
RJFpB|RJF-B
RKLY|RKLY
RKLY.WS|RKLY+
RKT|RKT
RKTA|RKTA
RKTA.U|RKTA=
RKTA.WS|RKTA+
RL|RL
RLGT|RLGT
RLI|RLI
RLJ|RLJ
RLJpA|RLJ-A
RLTY|RLTY
RLX|RLX
RLY|RLY
RM|RM
RMAX|RMAX
RMD|RMD
RMED|RMED
RMI|RMI
RMM|RMM
RMMZ|RMMZ
RMPLp|RMPL-
RMT|RMT
RNG|RNG
RNGR|RNGR
RNP|RNP
RNR|RNR
RNRpF|RNR-F
RNRpG|RNR-G
ROAM|ROAM
ROBO|ROBO
ROCI|ROCI
RODE|RODE
RODI|RODI
RODM|RODM
ROG|ROG
ROK|ROK
ROKT|ROKT
ROL|ROL
ROM|ROM
ROMO|ROMO
RONI|RONI
RONI.U|RONI=
RONI.WS|RONI+
ROOF|ROOF
ROP|ROP
RORO|RORO
ROSC|ROSC
ROSS|ROSS
ROSS.U|ROSS=
ROSS.WS|ROSS+
ROUS|ROUS
RPAR|RPAR
RPG|RPG
RPHS|RPHS
RPM|RPM
RPT|RPT
RPTpD|RPT-D
RPV|RPV
RQI|RQI
RRAC|RRAC
RRAC.U|RRAC=
RRAC.WS|RRAC+
RRC|RRC
RRH|RRH
RRX|RRX
RS|RS
RSEE|RSEE
RSF|RSF
RSG|RSG
RSI|RSI
RSKD|RSKD
RSP|RSP
RSPE|RSPE
RSPY|RSPY
RSX|RSX
RSXJ|RSXJ
RTAI|RTAI
RTM|RTM
RTO|RTO
RTX|RTX
RTYD|RTYD
RUFF|RUFF
RULE|RULE
RVLV|RVLV
RVNU|RVNU
RVP|RVP
RVRB|RVRB
RVT|RVT
RWJ|RWJ
RWK|RWK
RWL|RWL
RWM|RWM
RWO|RWO
RWR|RWR
RWT|RWT
RWX|RWX
RXD|RXD
RXI|RXI
RXL|RXL
RXO|RXO
RY|RY
RYpT|RY-T
RYAM|RYAM
RYAN|RYAN
RYE|RYE
RYF|RYF
RYH|RYH
RYI|RYI
RYJ|RYJ
RYLD|RYLD
RYLG|RYLG
RYN|RYN
RYT|RYT
RYU|RYU
RZA|RZA
RZB|RZB
RZC|RZC
RZG|RZG
RZV|RZV
S|S
SA|SA
SAA|SAA
SACC|SACC
SACH|SACH
SACHpA|SACH-A
SAEF|SAEF
SAFE|SAFE
SAGP|SAGP
SAH|SAH
SAIC|SAIC
SAJ|SAJ
SAM|SAM
SAMT|SAMT
SAN|SAN
SAND|SAND
SAP|SAP
SAR|SAR
SAT|SAT
SATO|SATO
SATX|SATX
SATX.WS.A|SATX+A
SAVE|SAVE
SAVN|SAVN
SB|SB
SBpC|SB-C
SBpD|SB-D
SBB|SBB
SBBA|SBBA
SBEV|SBEV
SBEV.WS|SBEV+
SBH|SBH
SBI|SBI
SBIO|SBIO
SBND|SBND
SBOW|SBOW
SBR|SBR
SBS|SBS
SBSW|SBSW
SBUG|SBUG
SCC|SCC
SCCB|SCCB
SCCC|SCCC
SCCD|SCCD
SCCE|SCCE
SCCF|SCCF
SCCG|SCCG
SCCO|SCCO
SCD|SCD
SCDL|SCDL
SCEpG|SCE-G
SCEpH|SCE-H
SCEpJ|SCE-J
SCEpK|SCE-K
SCEpL|SCE-L
SCHA|SCHA
SCHB|SCHB
SCHC|SCHC
SCHD|SCHD
SCHE|SCHE
SCHF|SCHF
SCHG|SCHG
SCHH|SCHH
SCHI|SCHI
SCHJ|SCHJ
SCHK|SCHK
SCHM|SCHM
SCHO|SCHO
SCHP|SCHP
SCHQ|SCHQ
SCHR|SCHR
SCHV|SCHV
SCHW|SCHW
SCHWpD|SCHW-D
SCHWpJ|SCHW-J
SCHX|SCHX
SCHY|SCHY
SCHZ|SCHZ
SCI|SCI
SCJ|SCJ
SCL|SCL
SCM|SCM
SCMB|SCMB
SCO|SCO
SCRD|SCRD
SCS|SCS
SCU|SCU
SCUA|SCUA
SCUA.U|SCUA=
SCUA.WS|SCUA+
SCX|SCX
SD|SD
SDCI|SDCI
SDD|SDD
SDEF|SDEF
SDEI|SDEI
SDEM|SDEM
SDGA|SDGA
SDGS|SDGS
SDHY|SDHY
SDIV|SDIV
SDOG|SDOG
SDOW|SDOW
SDP|SDP
SDPI|SDPI
SDRL|SDRL
SDS|SDS
SDY|SDY
SE|SE
SEA|SEA
SEALpA|SEAL-A
SEALpB|SEAL-B
SEAS|SEAS
SEB|SEB
SECT|SECT
SEDA|SEDA
SEDA.U|SEDA=
SEDA.WS|SEDA+
SEE|SEE
SEF|SEF
SEIM|SEIM
SEIQ|SEIQ
SEIV|SEIV
SEIX|SEIX
SELV|SELV
SEM|SEM
SEMI|SEMI
SEMR|SEMR
SENS|SENS
SENT|SENT
SEPZ|SEPZ
SES|SES
SES.WS|SES+
SESG|SESG
SF|SF
SFpB|SF-B
SFpC|SF-C
SFpD|SF-D
SFB|SFB
SFBS|SFBS
SFIG|SFIG
SFL|SFL
SFLR|SFLR
SFY|SFY
SFYF|SFYF
SFYX|SFYX
SG|SG
SGDJ|SGDJ
SGDM|SGDM
SGFY|SGFY
SGG|SGG
SGHC|SGHC
SGHC.WS|SGHC+
SGOL|SGOL
SGOV|SGOV
SGU|SGU
SH|SH
SHAG|SHAG
SHAK|SHAK
SHAP|SHAP
SHAP.U|SHAP=
SHAP.WS|SHAP+
SHDG|SHDG
SHE|SHE
SHEL|SHEL
SHG|SHG
SHM|SHM
SHO|SHO
SHOpH|SHO-H
SHOpI|SHO-I
SHOC|SHOC
SHOP|SHOP
SHPP|SHPP
SHPW|SHPW
SHPW.WS|SHPW+
SHUS|SHUS
SHW|SHW
SHYD|SHYD
SHYG|SHYG
SHYL|SHYL
SI|SI
SIpA|SI-A
SID|SID
SIF|SIF
SIFI|SIFI
SIG|SIG
SIHY|SIHY
SII|SII
SIJ|SIJ
SIL|SIL
SILJ|SILJ
SILV|SILV
SILX|SILX
SIM|SIM
SIMS|SIMS
SIO|SIO
SIRE|SIRE
SITC|SITC
SITCpA|SITC-A
SITE|SITE
SIVR|SIVR
SIX|SIX
SIXA|SIXA
SIXH|SIXH
SIXJ|SIXJ
SIXL|SIXL
SIXO|SIXO
SIXS|SIXS
SIZE|SIZE
SJB|SJB
SJI|SJI
SJIJ|SJIJ
SJIV|SJIV
SJM|SJM
SJNK|SJNK
SJR|SJR
SJT|SJT
SJW|SJW
SKE|SKE
SKF|SKF
SKIL|SKIL
SKIL.WS|SKIL+
SKLZ|SKLZ
SKM|SKM
SKT|SKT
SKX|SKX
SKY|SKY
SKYH|SKYH
SKYH.WS|SKYH+
SLAC|SLAC
SLAC.U|SLAC=
SLAC.WS|SLAC+
SLB|SLB
SLCA|SLCA
SLF|SLF
SLG|SLG
SLGpI|SLG-I
SLGN|SLGN
SLI|SLI
SLQT|SLQT
SLV|SLV
SLVM|SLVM
SLVP|SLVP
SLX|SLX
SLY|SLY
SLYG|SLYG
SLYV|SLYV
SM|SM
SMAR|SMAR
SMB|SMB
SMDD|SMDD
SMDV|SMDV
SMDY|SMDY
SMFG|SMFG
SMG|SMG
SMHB|SMHB
SMHI|SMHI
SMI|SMI
SMIG|SMIG
SMIN|SMIN
SMLE|SMLE
SMLF|SMLF
SMLP|SMLP
SMLV|SMLV
SMMD|SMMD
SMMU|SMMU
SMMV|SMMV
SMN|SMN
SMOG|SMOG
SMOT|SMOT
SMP|SMP
SMR|SMR
SMR.WS|SMR+
SMRT|SMRT
SMWB|SMWB
SNA|SNA
SNAP|SNAP
SNDA|SNDA
SNDR|SNDR
SNMP|SNMP
SNN|SNN
SNOW|SNOW
SNPD|SNPD
SNPE|SNPE
SNPG|SNPG
SNPV|SNPV
SNV|SNV
SNVpD|SNV-D
SNVpE|SNV-E
SNX|SNX
SO|SO
SOI|SOI
SOJC|SOJC
SOJD|SOJD
SOJE|SOJE
SOL|SOL
SOLR|SOLR
SON|SON
SONX|SONX
SONY|SONY
SOR|SOR
SOS|SOS
SOXL|SOXL
SOXS|SOXS
SOYB|SOYB
SPAB|SPAB
SPAX|SPAX
SPB|SPB
SPBO|SPBO
SPCE|SPCE
SPCZ|SPCZ
SPD|SPD
SPDN|SPDN
SPDV|SPDV
SPDW|SPDW
SPE|SPE
SPEpC|SPE-C
SPEM|SPEM
SPEU|SPEU
SPFF|SPFF
SPG|SPG
SPGpJ|SPG-J
SPGI|SPGI
SPGM|SPGM
SPGP|SPGP
SPGS|SPGS
SPGS.U|SPGS=
SPH|SPH
SPHB|SPHB
SPHD|SPHD
SPHQ|SPHQ
SPHY|SPHY
SPIB|SPIB
SPIP|SPIP
SPIR|SPIR
SPIR.WS|SPIR+
SPKX|SPKX
SPKY|SPKY
SPLB|SPLB
SPLG|SPLG
SPLP|SPLP
SPLPpA|SPLP-A
SPLV|SPLV
SPMB|SPMB
SPMD|SPMD
SPMO|SPMO
SPMV|SPMV
SPNT|SPNT
SPNTpB|SPNT-B
SPOT|SPOT
SPPP|SPPP
SPR|SPR
SPRE|SPRE
SPRU|SPRU
SPSB|SPSB
SPSK|SPSK
SPSM|SPSM
SPTI|SPTI
SPTL|SPTL
SPTM|SPTM
SPTS|SPTS
SPUC|SPUC
SPUS|SPUS
SPUU|SPUU
SPVM|SPVM
SPVU|SPVU
SPXB|SPXB
SPXC|SPXC
SPXE|SPXE
SPXL|SPXL
SPXN|SPXN
SPXS|SPXS
SPXT|SPXT
SPXU|SPXU
SPXV|SPXV
SPXX|SPXX
SPY|SPY
SPYC|SPYC
SPYD|SPYD
SPYG|SPYG
SPYI|SPYI
SPYV|SPYV
SPYX|SPYX
SQ|SQ
SQEW|SQEW
SQM|SQM
SQNS|SQNS
SQSP|SQSP
SQZ|SQZ
SR|SR
SRpA|SR-A
SRC|SRC
SRCpA|SRC-A
SRE|SRE
SREA|SREA
SRG|SRG
SRGpA|SRG-A
SRHQ|SRHQ
SRI|SRI
SRL|SRL
SRLN|SRLN
SRS|SRS
SRT|SRT
SRTY|SRTY
SRV|SRV
SRVR|SRVR
SSD|SSD
SSFI|SSFI
SSG|SSG
SSL|SSL
SSLY|SSLY
SSO|SSO
SSPX|SSPX
SSPY|SSPY
SST|SST
SST.WS|SST+
SSTK|SSTK
SSU|SSU
SSU.WS|SSU+
SSUS|SSUS
SSXU|SSXU
SSY|SSY
ST|ST
STAG|STAG
STAR|STAR
STARpD|STAR-D
STARpG|STAR-G
STARpI|STAR-I
STC|STC
STCE|STCE
STE|STE
STEM|STEM
STET|STET
STET.U|STET=
STET.WS|STET+
STEW|STEW
STG|STG
STGF|STGF
STIP|STIP
STK|STK
STLA|STLA
STLG|STLG
STLV|STLV
STM|STM
STN|STN
STNC|STNC
STNG|STNG
STOR|STOR
STOT|STOT
STPZ|STPZ
STR|STR
STR.WS|STR+
STRE|STRE
STRE.U|STRE=
STRE.WS|STRE+
STRV|STRV
STRY|STRY
STRY.WS|STRY+
STT|STT
STTpD|STT-D
STTpG|STT-G
STVN|STVN
STWD|STWD
STXS|STXS
STZ|STZ
SU|SU
SUAC|SUAC
SUAC.U|SUAC=
SUAC.WS|SUAC+
SUB|SUB
SUBS|SUBS
SUI|SUI
SUM|SUM
SUN|SUN
SUNL|SUNL
SUNL.WS|SUNL+
SUP|SUP
SUPL|SUPL
SUPV|SUPV
SURE|SURE
SUSA|SUSA
SUZ|SUZ
SVAL|SVAL
SVIX|SVIX
SVM|SVM
SVOL|SVOL
SVT|SVT
SVXY|SVXY
SWAN|SWAN
SWAR|SWAR
SWCH|SWCH
SWI|SWI
SWK|SWK
SWN|SWN
SWX|SWX
SWZ|SWZ
SXC|SXC
SXI|SXI
SXQG|SXQG
SXT|SXT
SXUS|SXUS
SYF|SYF
SYFpA|SYF-A
SYII|SYII
SYK|SYK
SYLD|SYLD
SYNB|SYNB
SYUS|SYUS
SYY|SYY
SZK|SZK
SZNE|SZNE
T|T
TpA|T-A
TpC|T-C
TAC|TAC
TACK|TACK
TAFI|TAFI
TAGG|TAGG
TAGS|TAGS
TAIL|TAIL
TAK|TAK
TAL|TAL
TALO|TALO
TAN|TAN
TAP|TAP
TAP.A|TAP.A
TARO|TARO
TAXF|TAXF
TBB|TBB
TBC|TBC
TBF|TBF
TBI|TBI
TBJL|TBJL
TBT|TBT
TBUX|TBUX
TBX|TBX
TCHP|TCHP
TCI|TCI
TCN|TCN
TCOA|TCOA
TCOA.U|TCOA=
TCOA.WS|TCOA+
TCS|TCS
TD|TD
TDC|TDC
TDCX|TDCX
TDF|TDF
TDG|TDG
TDOC|TDOC
TDS|TDS
TDSpU|TDS-U
TDSpV|TDS-V
TDSA|TDSA
TDSB|TDSB
TDSC|TDSC
TDSD|TDSD
TDSE|TDSE
TDTF|TDTF
TDTT|TDTT
TDV|TDV
TDVG|TDVG
TDW|TDW
TDW.WS.A|TDW+A
TDW.WS.B|TDW+B
TDW.WS|TDW+
TDY|TDY
TEAF|TEAF
TECB|TECB
TECK|TECK
TECL|TECL
TECS|TECS
TEF|TEF
TEI|TEI
TEL|TEL
TELL|TELL
TELZ|TELZ
TEMP|TEMP
TEO|TEO
TEQI|TEQI
TEVA|TEVA
TEX|TEX
TFC|TFC
TFCpI|TFC-I
TFCpO|TFC-O
TFCpR|TFC-R
TFI|TFI
TFII|TFII
TFJL|TFJL
TFLO|TFLO
TFLR|TFLR
TFPM|TFPM
TFSA|TFSA
TFX|TFX
TG|TG
TGB|TGB
TGH|TGH
TGHpA|TGH-A
TGHpB|TGH-B
TGI|TGI
TGIF|TGIF
TGLS|TGLS
TGN|TGN
TGNA|TGNA
TGR|TGR
TGR.U|TGR=
TGR.WS|TGR+
TGRW|TGRW
TGS|TGS
TGT|TGT
THC|THC
THCX|THCX
THD|THD
THG|THG
THLV|THLV
THM|THM
THNQ|THNQ
THO|THO
THQ|THQ
THR|THR
THS|THS
THW|THW
THY|THY
THYF|THYF
TILL|TILL
TILT|TILT
TIMB|TIMB
TIME|TIME
TINT|TINT
TINY|TINY
TIP|TIP
TIPD|TIPD
TIPL|TIPL
TIPX|TIPX
TIPZ|TIPZ
TISI|TISI
TIXT|TIXT
TJX|TJX
TK|TK
TKAT|TKAT
TKC|TKC
TKR|TKR
TLGA|TLGA
TLGA.U|TLGA=
TLH|TLH
TLK|TLK
TLTD|TLTD
TLTE|TLTE
TLTW|TLTW
TLYS|TLYS
TM|TM
TMAT|TMAT
TMBR|TMBR
TMDV|TMDV
TME|TME
TMF|TMF
TMFC|TMFC
TMFE|TMFE
TMFG|TMFG
TMFM|TMFM
TMFS|TMFS
TMFX|TMFX
TMHC|TMHC
TMO|TMO
TMP|TMP
TMQ|TMQ
TMST|TMST
TMV|TMV
TNA|TNA
TNC|TNC
TNET|TNET
TNK|TNK
TNL|TNL
TNP|TNP
TNPpD|TNP-D
TNPpE|TNP-E
TNPpF|TNP-F
TOK|TOK
TOKE|TOKE
TOL|TOL
TOLZ|TOLZ
TOST|TOST
TOTL|TOTL
TOTR|TOTR
TOVX|TOVX
TPB|TPB
TPC|TPC
TPH|TPH
TPHD|TPHD
TPHE|TPHE
TPHS|TPHS
TPIF|TPIF
TPL|TPL
TPLC|TPLC
TPLE|TPLE
TPOR|TPOR
TPR|TPR
TPSC|TPSC
TPTA|TPTA
TPVG|TPVG
TPX|TPX
TPYP|TPYP
TPZ|TPZ
TR|TR
TRAQ|TRAQ
TRAQ.U|TRAQ=
TRAQ.WS|TRAQ+
TRC|TRC
TRCA|TRCA
TRCA.U|TRCA=
TRCA.WS|TRCA+
TREX|TREX
TRFK|TRFK
TRFM|TRFM
TRGP|TRGP
TRI|TRI
TRIS|TRIS
TRIS.U|TRIS=
TRIS.WS|TRIS+
TRN|TRN
TRND|TRND
TRNO|TRNO
TROX|TROX
TRP|TRP
TRPL|TRPL
TRQ|TRQ
TRT|TRT
TRTL|TRTL
TRTL.U|TRTL=
TRTL.WS|TRTL+
TRTN|TRTN
TRTNpA|TRTN-A
TRTNpB|TRTN-B
TRTNpC|TRTN-C
TRTNpD|TRTN-D
TRTNpE|TRTN-E
TRTX|TRTX
TRTXpC|TRTX-C
TRTY|TRTY
TRU|TRU
TRV|TRV
TRX|TRX
TS|TS
TSE|TSE
TSI|TSI
TSJA|TSJA
TSLH|TSLH
TSLX|TSLX
TSLY|TSLY
TSM|TSM
TSME|TSME
TSN|TSN
TSOC|TSOC
TSPA|TSPA
TSPQ|TSPQ
TSPQ.U|TSPQ=
TSQ|TSQ
TT|TT
TTAC|TTAC
TTAI|TTAI
TTC|TTC
TTE|TTE
TTI|TTI
TTM|TTM
TTP|TTP
TTT|TTT
TU|TU
TUA|TUA
TUP|TUP
TUSI|TUSI
TUYA|TUYA
TV|TV
TVC|TVC
TVE|TVE
TWI|TWI
TWIO|TWIO
TWLO|TWLO
TWM|TWM
TWN|TWN
TWND|TWND
TWND.U|TWND=
TWND.WS|TWND+
TWNI|TWNI
TWNI.U|TWNI=
TWO|TWO
TWOpA|TWO-A
TWOpB|TWO-B
TWOpC|TWO-C
TWOA|TWOA
TX|TX
TXT|TXT
TY|TY
TYp|TY-
TYA|TYA
TYD|TYD
TYG|TYG
TYL|TYL
TYLG|TYLG
TYNE|TYNE
TYO|TYO
TZA|TZA
U|U
UA|UA
UAA|UAA
UAMY|UAMY
UAN|UAN
UAPR|UAPR
UAUG|UAUG
UAV|UAV
UAVS|UAVS
UBA|UBA
UBCB|UBCB
UBER|UBER
UBOT|UBOT
UBP|UBP
UBPpH|UBP-H
UBPpK|UBP-K
UBR|UBR
UBS|UBS
UBT|UBT
UCC|UCC
UCIB|UCIB
UCO|UCO
UCON|UCON
UDEC|UDEC
UDI|UDI
UDIV|UDIV
UDN|UDN
UDOW|UDOW
UDR|UDR
UE|UE
UEC|UEC
UFAB|UFAB
UFEB|UFEB
UFI|UFI
UGA|UGA
UGE|UGE
UGI|UGI
UGIC|UGIC
UGL|UGL
UGP|UGP
UHS|UHS
UHT|UHT
UI|UI
UIS|UIS
UJAN|UJAN
UJB|UJB
UJUL|UJUL
UJUN|UJUN
UL|UL
ULE|ULE
ULST|ULST
ULTR|ULTR
UMAR|UMAR
UMAY|UMAY
UMC|UMC
UMDD|UMDD
UMH|UMH
UMHpD|UMH-D
UMI|UMI
UNF|UNF
UNFI|UNFI
UNG|UNG
UNH|UNH
UNL|UNL
UNM|UNM
UNMA|UNMA
UNOV|UNOV
UNP|UNP
UNVR|UNVR
UOCT|UOCT
UP|UP
UP.WS|UP+
UPAR|UPAR
UPH|UPH
UPH.WS|UPH+
UPRO|UPRO
UPS|UPS
UPV|UPV
UPW|UPW
URA|URA
URE|URE
URG|URG
URI|URI
URNM|URNM
URTH|URTH
URTY|URTY
USA|USA
USAC|USAC
USAI|USAI
USAS|USAS
USB|USB
USBpA|USB-A
USBpH|USB-H
USBpP|USB-P
USBpQ|USB-Q
USBpR|USB-R
USBpS|USB-S
USCI|USCI
USD|USD
USDP|USDP
USDU|USDU
USEP|USEP
USEQ|USEQ
USER|USER
USFD|USFD
USFR|USFR
USHY|USHY
USI|USI
USL|USL
USM|USM
USMF|USMF
USML|USML
USMV|USMV
USNA|USNA
USNZ|USNZ
USO|USO
USPH|USPH
USPX|USPX
USRT|USRT
USSG|USSG
UST|UST
USVT|USVT
USX|USX
UTES|UTES
UTF|UTF
UTG|UTG
UTI|UTI
UTL|UTL
UTRN|UTRN
UTSL|UTSL
UTZ|UTZ
UUP|UUP
UUU|UUU
UUUU|UUUU
UVDV|UVDV
UVE|UVE
UVIX|UVIX
UVV|UVV
UVXY|UVXY
UWM|UWM
UWMC|UWMC
UWMC.WS|UWMC+
UXI|UXI
UYG|UYG
UYLD|UYLD
UYM|UYM
UZD|UZD
UZE|UZE
UZF|UZF
V|V
VABS|VABS
VAC|VAC
VAL|VAL
VAL.WS|VAL+
VALE|VALE
VALQ|VALQ
VALT|VALT
VAMO|VAMO
VAPO|VAPO
VATE|VATE
VAW|VAW
VB|VB
VBF|VBF
VBK|VBK
VBND|VBND
VBR|VBR
VCAR|VCAR
VCEB|VCEB
VCIF|VCIF
VCLN|VCLN
VCLO|VCLO
VCR|VCR
VCV|VCV
VCXB|VCXB
VCXB.U|VCXB=
VCXB.WS|VCXB+
VDC|VDC
VDE|VDE
VDNI|VDNI
VEA|VEA
VEEV|VEEV
VEGA|VEGA
VEGI|VEGI
VEGN|VEGN
VEL|VEL
VERS|VERS
VET|VET
VEU|VEU
VFC|VFC
VFH|VFH
VFL|VFL
VFMF|VFMF
VFMO|VFMO
VFMV|VFMV
VFQY|VFQY
VFVA|VFVA
VGI|VGI
VGK|VGK
VGM|VGM
VGR|VGR
VGT|VGT
VGZ|VGZ
VHAQ|VHAQ
VHAQr|VHAQ^
VHAQ.U|VHAQ=
VHAQ.WS|VHAQ+
VHC|VHC
VHI|VHI
VHT|VHT
VIAO|VIAO
VICE|VICE
VICI|VICI
VIDI|VIDI
VIG|VIG
VINE|VINE
VIOG|VIOG
VIOO|VIOO
VIOV|VIOV
VIPS|VIPS
VIRS|VIRS
VIS|VIS
VIST|VIST
VIV|VIV
VIXM|VIXM
VIXY|VIXY
VKI|VKI
VKQ|VKQ
VLD|VLD
VLD.WS|VLD+
VLN|VLN
VLN.WS|VLN+
VLO|VLO
VLRS|VLRS
VLT|VLT
VLTA|VLTA
VLTA.WS|VLTA+
VLU|VLU
VLUE|VLUE
VMAT|VMAT
VMC|VMC
VMI|VMI
VMO|VMO
VMOT|VMOT
VMW|VMW
VNAM|VNAM
VNCE|VNCE
VNLA|VNLA
VNM|VNM
VNMC|VNMC
VNO|VNO
VNOpL|VNO-L
VNOpM|VNO-M
VNOpN|VNO-N
VNOpO|VNO-O
VNQ|VNQ
VNRX|VNRX
VNSE|VNSE
VNT|VNT
VNTR|VNTR
VO|VO
VOC|VOC
VOE|VOE
VOO|VOO
VOOG|VOOG
VOOV|VOOV
VOT|VOT
VOTE|VOTE
VOX|VOX
VOYA|VOYA
VOYApB|VOYA-B
VPC|VPC
VPG|VPG
VPL|VPL
VPU|VPU
VPV|VPV
VRAI|VRAI
VRE|VRE
VRP|VRP
VRT|VRT
VRTV|VRTV
VSCO|VSCO
VSGX|VSGX
VSH|VSH
VSLU|VSLU
VSS|VSS
VST|VST
VST.WS.A|VST+A
VSTO|VSTO
VT|VT
VTEB|VTEB
VTEX|VTEX
VTI|VTI
VTN|VTN
VTOL|VTOL
VTR|VTR
VTV|VTV
VUG|VUG
VUSB|VUSB
VUSE|VUSE
VV|VV
VVI|VVI
VVNT|VVNT
VVR|VVR
VVV|VVV
VVX|VVX
VWID|VWID
VWO|VWO
VXF|VXF
VXX|VXX
VXZ|VXZ
VYM|VYM
VZ|VZ
VZIO|VZIO
VZLA|VZLA
W|W
WAB|WAB
WAL|WAL
WALpA|WAL-A
WANT|WANT
WAT|WAT
WAVC|WAVC
WAVC.U|WAVC=
WAVC.WS|WAVC+
WBAT|WBAT
WBEV|WBEV
WBIF|WBIF
WBIG|WBIG
WBIL|WBIL
WBIY|WBIY
WBS|WBS
WBSpF|WBS-F
WBSpG|WBS-G
WBX|WBX
WBX.WS|WBX+
WCC|WCC
WCCpA|WCC-A
WCN|WCN
WD|WD
WDH|WDH
WDI|WDI
WDIV|WDIV
WDNA|WDNA
WDS|WDS
WE|WE
WE.WS|WE+
WEA|WEA
WEAT|WEAT
WEAV|WEAV
WEBL|WEBL
WEBR|WEBR
WEBS|WEBS
WEC|WEC
WEED|WEED
WEIX|WEIX
WEL|WEL
WEL.U|WEL=
WEL.WS|WEL+
WELL|WELL
WES|WES
WEX|WEX
WF|WF
WFC|WFC
WFCpA|WFC-A
WFCpC|WFC-C
WFCpD|WFC-D
WFCpL|WFC-L
WFCpQ|WFC-Q
WFCpR|WFC-R
WFCpY|WFC-Y
WFCpZ|WFC-Z
WFG|WFG
WFH|WFH
WFHY|WFHY
WFIG|WFIG
WGO|WGO
WH|WH
WHD|WHD
WHG|WHG
WHR|WHR
WIA|WIA
WIL|WIL
WINN|WINN
WIP|WIP
WIT|WIT
WIW|WIW
WK|WK
WKLY|WKLY
WLDR|WLDR
WLK|WLK
WLKP|WLKP
WLMS|WLMS
WLTG|WLTG
WLTH|WLTH
WLY|WLY
WLYB|WLYB
WM|WM
WMB|WMB
WMC|WMC
WMK|WMK
WMS|WMS
WMT|WMT
WNC|WNC
WNNR|WNNR
WNNR.U|WNNR=
WNNR.WS|WNNR+
WNS|WNS
WOLF|WOLF
WOMN|WOMN
WOR|WOR
WOW|WOW
WPC|WPC
WPCA|WPCA
WPCA.U|WPCA=
WPCB|WPCB
WPCB.U|WPCB=
WPM|WPM
WPP|WPP
WPS|WPS
WQGA|WQGA
WQGA.U|WQGA=
WQGA.WS|WQGA+
WRAC|WRAC
WRAC.U|WRAC=
WRAC.WS|WRAC+
WRB|WRB
WRBpE|WRB-E
WRBpF|WRB-F
WRBpG|WRB-G
WRBpH|WRB-H
WRBY|WRBY
WRK|WRK
WRN|WRN
WSM|WSM
WSO|WSO
WSO.B|WSO.B
WSR|WSR
WST|WST
WT|WT
WTAI|WTAI
WTI|WTI
WTM|WTM
WTMF|WTMF
WTRE|WTRE
WTRG|WTRG
WTS|WTS
WTT|WTT
WTTR|WTTR
WTV|WTV
WU|WU
WUGI|WUGI
WWE|WWE
WWJD|WWJD
WWR|WWR
WWW|WWW
WY|WY
WYY|WYY
X|X
XAR|XAR
XB|XB
XBAP|XBAP
XBB|XBB
XBI|XBI
XBJA|XBJA
XBJL|XBJL
XBOC|XBOC
XBTF|XBTF
XC|XC
XCCC|XCCC
XCEM|XCEM
XCLR|XCLR
XCOR|XCOR
XDAP|XDAP
XDAT|XDAT
XDEC|XDEC
XDJA|XDJA
XDJL|XDJL
XDOC|XDOC
XDQQ|XDQQ
XDSQ|XDSQ
XEMD|XEMD
XES|XES
XFIV|XFIV
XFLT|XFLT
XFLTpA|XFLT-A
XHB|XHB
XHE|XHE
XHLF|XHLF
XHR|XHR
XHS|XHS
XHYC|XHYC
XHYD|XHYD
XHYE|XHYE
XHYF|XHYF
XHYH|XHYH
XHYI|XHYI
XHYT|XHYT
XIN|XIN
XITK|XITK
XJH|XJH
XJR|XJR
XJUN|XJUN
XLB|XLB
XLC|XLC
XLE|XLE
XLF|XLF
XLG|XLG
XLI|XLI
XLK|XLK
XLP|XLP
XLRE|XLRE
XLSR|XLSR
XLU|XLU
XLV|XLV
XLY|XLY
XME|XME
XMHQ|XMHQ
XMLV|XMLV
XMMO|XMMO
XMPT|XMPT
XMVM|XMVM
XNAV|XNAV
XNTK|XNTK
XOM|XOM
XONE|XONE
XOP|XOP
XOUT|XOUT
XPER|XPER
XPEV|XPEV
XPH|XPH
XPL|XPL
XPND|XPND
XPO|XPO
XPOF|XPOF
XPP|XPP
XPRO|XPRO
XRLV|XRLV
XRMI|XRMI
XRT|XRT
XSD|XSD
XSEP|XSEP
XSHD|XSHD
XSHQ|XSHQ
XSLV|XSLV
XSMO|XSMO
XSOE|XSOE
XSVM|XSVM
XSVN|XSVN
XSW|XSW
XTAP|XTAP
XTEN|XTEN
XTJA|XTJA
XTJL|XTJL
XTL|XTL
XTN|XTN
XTNT|XTNT
XTOC|XTOC
XTR|XTR
XTRE|XTRE
XTWO|XTWO
XTWY|XTWY
XUSP|XUSP
XVOL|XVOL
XVV|XVV
XWEB|XWEB
XYF|XYF
XYL|XYL
XYLD|XYLD
XYLG|XYLG
YALA|YALA
YALL|YALL
YANG|YANG
YCBD|YCBD
YCBDpA|YCBD-A
YCL|YCL
YCS|YCS
YDEC|YDEC
YEAR|YEAR
YELP|YELP
YETI|YETI
YEXT|YEXT
YINN|YINN
YJUN|YJUN
YLD|YLD
YMAR|YMAR
YMM|YMM
YOLO|YOLO
YOU|YOU
YPF|YPF
YPS|YPS
YRD|YRD
YSEP|YSEP
YSG|YSG
YTPG|YTPG
YUM|YUM
YUMC|YUMC
YUMY|YUMY
YXI|YXI
YYY|YYY
ZBH|ZBH
ZBZX|ZBZX
ZDGE|ZDGE
ZECP|ZECP
ZEPP|ZEPP
ZETA|ZETA
ZEV|ZEV
ZEV.WS|ZEV+
ZEXIT|ZEXIT
ZGN|ZGN
ZGN.WS|ZGN+
ZH|ZH
ZHDG|ZHDG
ZIEXT|ZIEXT
ZIG|ZIG
ZIM|ZIM
ZIP|ZIP
ZNH|ZNH
ZOM|ZOM
ZROZ|ZROZ
ZSL|ZSL
ZTEST|ZTEST
ZTO|ZTO
ZTR|ZTR
ZTS|ZTS
ZUO|ZUO
ZVIA|ZVIA
ZVV|ZVV
ZWS|ZWS
ZXIET|ZXIET
ZYME|ZYME