cms_suffix|cqs_suffix
A|A
AA|AA
AAA|AAA
AAAU|AAAU
AAC|AAC
AAC U|AAC.U
AAC WS|AAC.WS
AACG|AACG
AACI|AACI
AACIU|AACIU
AACIW|AACIW
AADI|AADI
AADR|AADR
AAIC|AAIC
AAIC PRB|AAICpB
AAIC PRC|AAICpC
AAIN|AAIN
AAL|AAL
AAM PRA|AAMpA
AAM PRB|AAMpB
AAMC|AAMC
AAME|AAME
AAN|AAN
AAOI|AAOI
AAON|AAON
AAP|AAP
AAPB|AAPB
AAPD|AAPD
AAPL|AAPL
AAPU|AAPU
AAQC|AAQC
AAQC U|AAQC.U
AAT|AAT
AATC|AATC
AAU|AAU
AAWW|AAWW
AAXJ|AAXJ
AB|AB
ABB|ABB
ABBV|ABBV
ABC|ABC
ABCB|ABCB
ABCL|ABCL
ABCM|ABCM
ABEO|ABEO
ABEQ|ABEQ
ABEV|ABEV
ABG|ABG
ABGI|ABGI
ABIO|ABIO
ABM|ABM
ABMD|ABMD
ABNB|ABNB
ABOS|ABOS
ABR|ABR
ABR PRD|ABRpD
ABR PRE|ABRpE
ABR PRF|ABRpF
ABSI|ABSI
ABST|ABST
ABT|ABT
ABUS|ABUS
ABVC|ABVC
AC|AC
ACA|ACA
ACAB|ACAB
ACABU|ACABU
ACABW|ACABW
ACAC|ACAC
ACACU|ACACU
ACACW|ACACW
ACAD|ACAD
ACAH|ACAH
ACAHU|ACAHU
ACAHW|ACAHW
ACAQ|ACAQ
ACAQ U|ACAQ.U
ACAQ WS|ACAQ.WS
ACAX|ACAX
ACAXR|ACAXR
ACAXU|ACAXU
ACAXW|ACAXW
ACB|ACB
ACBA|ACBA
ACBAU|ACBAU
ACBAW|ACBAW
ACCD|ACCD
ACCO|ACCO
ACDC|ACDC
ACDCW|ACDCW
ACDI|ACDI
ACDI U|ACDI.U
ACDI WS|ACDI.WS
ACEL|ACEL
ACER|ACER
ACES|ACES
ACET|ACET
ACGL|ACGL
ACGLN|ACGLN
ACGLO|ACGLO
ACHC|ACHC
ACHL|ACHL
ACHR|ACHR
ACHR WS|ACHR.WS
ACHV|ACHV
ACI|ACI
ACIO|ACIO
ACIU|ACIU
ACIW|ACIW
ACLS|ACLS
ACLX|ACLX
ACM|ACM
ACMR|ACMR
ACN|ACN
ACNB|ACNB
ACNT|ACNT
ACON|ACON
ACONW|ACONW
ACOR|ACOR
ACP|ACP
ACP PRA|ACPpA
ACQR|ACQR
ACQRU|ACQRU
ACQRW|ACQRW
ACR|ACR
ACR PRC|ACRpC
ACR PRD|ACRpD
ACRE|ACRE
ACRO|ACRO
ACRO U|ACRO.U
ACRO WS|ACRO.WS
ACRS|ACRS
ACRV|ACRV
ACRX|ACRX
ACSI|ACSI
ACST|ACST
ACT|ACT
ACTG|ACTG
ACTV|ACTV
ACU|ACU
ACV|ACV
ACVA|ACVA
ACVF|ACVF
ACWF|ACWF
ACWI|ACWI
ACWV|ACWV
ACWX|ACWX
ACXP|ACXP
ADAG|ADAG
ADAL|ADAL
ADALU|ADALU
ADALW|ADALW
ADAP|ADAP
ADBE|ADBE
ADC|ADC
ADC PRA|ADCpA
ADCT|ADCT
ADD|ADD
ADEA|ADEA
ADER|ADER
ADERU|ADERU
ADERW|ADERW
ADES|ADES
ADEX|ADEX
ADEX U|ADEX.U
ADEX WS|ADEX.WS
ADFI|ADFI
ADI|ADI
ADIL|ADIL
ADILW|ADILW
ADIV|ADIV
ADM|ADM
ADMA|ADMA
ADME|ADME
ADMP|ADMP
ADN|ADN
ADNT|ADNT
ADNWW|ADNWW
ADOC|ADOC
ADOCR|ADOCR
ADOCW|ADOCW
ADP|ADP
ADPT|ADPT
ADPV|ADPV
ADRA|ADRA
ADRA U|ADRA.U
ADRA WS|ADRA.WS
ADRE|ADRE
ADRT|ADRT
ADRT U|ADRT.U
ADSE|ADSE
ADSEW|ADSEW
ADSK|ADSK
ADT|ADT
ADTH|ADTH
ADTHW|ADTHW
ADTN|ADTN
ADTX|ADTX
ADUS|ADUS
ADV|ADV
ADVM|ADVM
ADVWW|ADVWW
ADX|ADX
ADXN|ADXN
AE|AE
AEAC|AEAC
AEACU|AEACU
AEACW|AEACW
AEAE|AEAE
AEAEU|AEAEU
AEAEW|AEAEW
AEE|AEE
AEF|AEF
AEFC|AEFC
AEG|AEG
AEHA|AEHA
AEHAU|AEHAU
AEHAW|AEHAW
AEHL|AEHL
AEHR|AEHR
AEI|AEI
AEIS|AEIS
AEL|AEL
AEL PRA|AELpA
AEL PRB|AELpB
AEM|AEM
AEMB|AEMB
AEMD|AEMD
AENZ|AENZ
AEO|AEO
AEP|AEP
AEPPZ|AEPPZ
AER|AER
AERC|AERC
AES|AES
AESC|AESC
AESR|AESR
AEVA|AEVA
AEVA WS|AEVA.WS
AEY|AEY
AEYE|AEYE
AEZS|AEZS
AFAC|AFAC
AFACU|AFACU
AFACW|AFACW
AFAQ|AFAQ
AFAQU|AFAQU
AFAQW|AFAQW
AFAR|AFAR
AFARU|AFARU
AFARW|AFARW
AFB|AFB
AFBI|AFBI
AFCG|AFCG
AFG|AFG
AFGB|AFGB
AFGC|AFGC
AFGD|AFGD
AFGE|AFGE
AFIB|AFIB
AFIF|AFIF
AFK|AFK
AFL|AFL
AFLG|AFLG
AFMC|AFMC
AFMD|AFMD
AFRI|AFRI
AFRIW|AFRIW
AFRM|AFRM
AFSM|AFSM
AFT|AFT
AFTR|AFTR
AFTR U|AFTR.U
AFTR WS|AFTR.WS
AFTY|AFTY
AFYA|AFYA
AG|AG
AGAC|AGAC
AGAC U|AGAC.U
AGAC WS|AGAC.WS
AGAE|AGAE
AGBA|AGBA
AGBAW|AGBAW
AGCB|AGCB
AGCO|AGCO
AGD|AGD
AGE|AGE
AGEN|AGEN
AGFS|AGFS
AGFY|AGFY
AGG|AGG
AGGH|AGGH
AGGR|AGGR
AGGRU|AGGRU
AGGRW|AGGRW
AGGY|AGGY
AGI|AGI
AGIH|AGIH
AGIL|AGIL
AGILW|AGILW
AGIO|AGIO
AGL|AGL
AGLE|AGLE
AGM|AGM
AGM A|AGM.A
AGM PRC|AGMpC
AGM PRD|AGMpD
AGM PRE|AGMpE
AGM PRF|AGMpF
AGM PRG|AGMpG
AGMH|AGMH
AGNC|AGNC
AGNCL|AGNCL
AGNCM|AGNCM
AGNCN|AGNCN
AGNCO|AGNCO
AGNCP|AGNCP
AGNG|AGNG
AGO|AGO
AGOV|AGOV
AGOX|AGOX
AGQ|AGQ
AGR|AGR
AGRH|AGRH
AGRI|AGRI
AGRIW|AGRIW
AGRO|AGRO
AGRX|AGRX
AGS|AGS
AGTI|AGTI
AGX|AGX
AGYS|AGYS
AGZ|AGZ
AGZD|AGZD
AHCO|AHCO
AHG|AHG
AHH|AHH
AHH PRA|AHHpA
AHHX|AHHX
AHI|AHI
AHL PRC|AHLpC
AHL PRD|AHLpD
AHL PRE|AHLpE
AHOY|AHOY
AHPI|AHPI
AHRN|AHRN
AHRNU|AHRNU
AHRNW|AHRNW
AHT|AHT
AHT PRD|AHTpD
AHT PRF|AHTpF
AHT PRG|AHTpG
AHT PRH|AHTpH
AHT PRI|AHTpI
AHYB|AHYB
AI|AI
AIA|AIA
AIB|AIB
AIBBR|AIBBR
AIBBU|AIBBU
AIC|AIC
AIEQ|AIEQ
AIF|AIF
AIG|AIG
AIG PRA|AIGpA
AIH|AIH
AIHS|AIHS
AIKI|AIKI
AILG|AILG
AILV|AILV
AIM|AIM
AIMAU|AIMAU
AIMAW|AIMAW
AIMBU|AIMBU
AIMC|AIMC
AIMD|AIMD
AIMDW|AIMDW
AIN|AIN
AINC|AINC
AIO|AIO
AIP|AIP
AIQ|AIQ
AIR|AIR
AIRC|AIRC
AIRG|AIRG
AIRI|AIRI
AIRR|AIRR
AIRS|AIRS
AIRT|AIRT
AIRTP|AIRTP
AIT|AIT
AIU|AIU
AIV|AIV
AIVI|AIVI
AIVL|AIVL
AIZ|AIZ
AIZN|AIZN
AJG|AJG
AJRD|AJRD
AJX|AJX
AJXA|AJXA
AKA|AKA
AKAM|AKAM
AKAN|AKAN
AKBA|AKBA
AKIC|AKIC
AKICU|AKICU
AKICW|AKICW
AKLI|AKLI
AKO A|AKO.A
AKO B|AKO.B
AKR|AKR
AKRO|AKRO
AKTS|AKTS
AKTX|AKTX
AKU|AKU
AKYA|AKYA
AL|AL
AL PRA|ALpA
ALB|ALB
ALBO|ALBO
ALBT|ALBT
ALC|ALC
ALCC|ALCC
ALCO|ALCO
ALDX|ALDX
ALE|ALE
ALEC|ALEC
ALEX|ALEX
ALG|ALG
ALGM|ALGM
ALGN|ALGN
ALGS|ALGS
ALGT|ALGT
ALHC|ALHC
ALIM|ALIM
ALIT|ALIT
ALK|ALK
ALKS|ALKS
ALKT|ALKT
ALL|ALL
ALL PRB|ALLpB
ALL PRG|ALLpG
ALL PRH|ALLpH
ALL PRI|ALLpI
ALLE|ALLE
ALLG|ALLG
ALLG WS|ALLG.WS
ALLK|ALLK
ALLO|ALLO
ALLR|ALLR
ALLT|ALLT
ALLY|ALLY
ALNY|ALNY
ALOR|ALOR
ALORU|ALORU
ALORW|ALORW
ALOT|ALOT
ALPA|ALPA
ALPAU|ALPAU
ALPAW|ALPAW
ALPN|ALPN
ALPP|ALPP
ALPS|ALPS
ALR|ALR
ALRM|ALRM
ALRN|ALRN
ALRS|ALRS
ALSA|ALSA
ALSAR|ALSAR
ALSAU|ALSAU
ALSAW|ALSAW
ALSN|ALSN
ALT|ALT
ALTG|ALTG
ALTG PRA|ALTGpA
ALTL|ALTL
ALTO|ALTO
ALTR|ALTR
ALTU|ALTU
ALTUU|ALTUU
ALTUW|ALTUW
ALTY|ALTY
ALV|ALV
ALVO|ALVO
ALVOW|ALVOW
ALVR|ALVR
ALX|ALX
ALXO|ALXO
ALYA|ALYA
ALZN|ALZN
AM|AM
AMAL|AMAL
AMAM|AMAM
AMAO|AMAO
AMAOU|AMAOU
AMAOW|AMAOW
AMAT|AMAT
AMAX|AMAX
AMBA|AMBA
AMBC|AMBC
AMBC WS|AMBC.WS
AMBO|AMBO
AMBP|AMBP
AMBP WS|AMBP.WS
AMC|AMC
AMCI|AMCI
AMCIU|AMCIU
AMCIW|AMCIW
AMCR|AMCR
AMCX|AMCX
AMD|AMD
AME|AME
AMED|AMED
AMEH|AMEH
AMG|AMG
AMGN|AMGN
AMH|AMH
AMH PRG|AMHpG
AMH PRH|AMHpH
AMID|AMID
AMJ|AMJ
AMK|AMK
AMKR|AMKR
AMLP|AMLP
AMLX|AMLX
AMN|AMN
AMNA|AMNA
AMNB|AMNB
AMND|AMND
AMOM|AMOM
AMOT|AMOT
AMOV|AMOV
AMP|AMP
AMPE|AMPE
AMPG|AMPG
AMPGW|AMPGW
AMPH|AMPH
AMPI|AMPI
AMPI U|AMPI.U
AMPL|AMPL
AMPS|AMPS
AMPX|AMPX
AMPX WS|AMPX.WS
AMPY|AMPY
AMR|AMR
AMRC|AMRC
AMRK|AMRK
AMRN|AMRN
AMRS|AMRS
AMRX|AMRX
AMS|AMS
AMSC|AMSC
AMSF|AMSF
AMST|AMST
AMSWA|AMSWA
AMT|AMT
AMTB|AMTB
AMTD|AMTD
AMTI|AMTI
AMTR|AMTR
AMTX|AMTX
AMUB|AMUB
AMV|AMV
AMWD|AMWD
AMWL|AMWL
AMX|AMX
AMYT|AMYT
AMZA|AMZA
AMZD|AMZD
AMZN|AMZN
AMZU|AMZU
AN|AN
ANAB|ANAB
ANAC|ANAC
ANAC U|ANAC.U
ANAC WS|ANAC.WS
ANDE|ANDE
ANEB|ANEB
ANET|ANET
ANEW|ANEW
ANF|ANF
ANGH|ANGH
ANGHW|ANGHW
ANGI|ANGI
ANGL|ANGL
ANGN|ANGN
ANGO|ANGO
ANIK|ANIK
ANIP|ANIP
ANIX|ANIX
ANNX|ANNX
ANPC|ANPC
ANSS|ANSS
ANTE|ANTE
ANTX|ANTX
ANVS|ANVS
ANY|ANY
ANZU|ANZU
ANZUU|ANZUU
ANZUW|ANZUW
AOA|AOA
AOD|AOD
AOGO|AOGO
AOGOU|AOGOU
AOGOW|AOGOW
AOK|AOK
AOM|AOM
AOMR|AOMR
AON|AON
AOR|AOR
AORT|AORT
AOS|AOS
AOSL|AOSL
AOTG|AOTG
AOUT|AOUT
AP|AP
AP WS|AP.WS
APA|APA
APAC|APAC
APACU|APACU
APACW|APACW
APAM|APAM
APCA|APCA
APCA U|APCA.U
APCA WS|APCA.WS
APCX|APCX
APCXW|APCXW
APD|APD
APDN|APDN
APE|APE
APEI|APEI
APEN|APEN
APG|APG
APGB|APGB
APGB U|APGB.U
APGB WS|APGB.WS
APGN|APGN
APGNW|APGNW
APH|APH
API|API
APLD|APLD
APLE|APLE
APLS|APLS
APLT|APLT
APM|APM
APMI|APMI
APMIU|APMIU
APMIW|APMIW
APN|APN
APN U|APN.U
APN WS|APN.WS
APO|APO
APOG|APOG
APP|APP
APPF|APPF
APPH|APPH
APPHW|APPHW
APPN|APPN
APPS|APPS
APRE|APRE
APRN|APRN
APRT|APRT
APRW|APRW
APRZ|APRZ
APT|APT
APTM|APTM
APTMU|APTMU
APTMW|APTMW
APTO|APTO
APTV|APTV
APTV PRA|APTVpA
APTX|APTX
APVO|APVO
APWC|APWC
APXH|APXH
APXI|APXI
APXIU|APXIU
APXIW|APXIW
APYX|APYX
AQB|AQB
AQGX|AQGX
AQMS|AQMS
AQN|AQN
AQNA|AQNA
AQNB|AQNB
AQNU|AQNU
AQST|AQST
AQU|AQU
AQUA|AQUA
AQUNR|AQUNR
AQUNU|AQUNU
AQWA|AQWA
AR|AR
ARAV|ARAV
ARAY|ARAY
ARB|ARB
ARBE|ARBE
ARBEW|ARBEW
ARBG|ARBG
ARBGU|ARBGU
ARBGW|ARBGW
ARBK|ARBK
ARBKL|ARBKL
ARC|ARC
ARCB|ARCB
ARCC|ARCC
ARCE|ARCE
ARCH|ARCH
ARCK|ARCK
ARCKU|ARCKU
ARCKW|ARCKW
ARCM|ARCM
ARCO|ARCO
ARCT|ARCT
ARDC|ARDC
ARDS|ARDS
ARDX|ARDX
ARE|ARE
AREB|AREB
AREBW|AREBW
AREC|AREC
AREN|AREN
ARES|ARES
ARGD|ARGD
ARGO|ARGO
ARGO PRA|ARGOpA
ARGT|ARGT
ARGU|ARGU
ARGUU|ARGUU
ARGUW|ARGUW
ARGX|ARGX
ARHS|ARHS
ARI|ARI
ARIS|ARIS
ARIZ|ARIZ
ARIZR|ARIZR
ARIZU|ARIZU
ARIZW|ARIZW
ARKF|ARKF
ARKG|ARKG
ARKK|ARKK
ARKO|ARKO
ARKOW|ARKOW
ARKQ|ARKQ
ARKR|ARKR
ARKW|ARKW
ARKX|ARKX
ARL|ARL
ARLO|ARLO
ARLP|ARLP
ARMK|ARMK
ARMP|ARMP
ARMR|ARMR
ARNC|ARNC
AROC|AROC
AROW|AROW
ARQQ|ARQQ
ARQQW|ARQQW
ARQT|ARQT
ARR|ARR
ARR PRC|ARRpC
ARRW|ARRW
ARRWU|ARRWU
ARRWW|ARRWW
ARRY|ARRY
ARTE|ARTE
ARTEU|ARTEU
ARTEW|ARTEW
ARTL|ARTL
ARTLW|ARTLW
ARTNA|ARTNA
ARTW|ARTW
ARVL|ARVL
ARVN|ARVN
ARVR|ARVR
ARW|ARW
ARWR|ARWR
ARYD|ARYD
ARYE|ARYE
ASA|ASA
ASAI|ASAI
ASAN|ASAN
ASAP|ASAP
ASAX|ASAX
ASAXU|ASAXU
ASAXW|ASAXW
ASB|ASB
ASB PRE|ASBpE
ASB PRF|ASBpF
ASC|ASC
ASCA|ASCA
ASCAR|ASCAR
ASCAU|ASCAU
ASCAW|ASCAW
ASCB|ASCB
ASCBR|ASCBR
ASCBU|ASCBU
ASCBW|ASCBW
ASEA|ASEA
ASET|ASET
ASG|ASG
ASGI|ASGI
ASGN|ASGN
ASH|ASH
ASHR|ASHR
ASHS|ASHS
ASHX|ASHX
ASIX|ASIX
ASLE|ASLE
ASLN|ASLN
ASM|ASM
ASMB|ASMB
ASML|ASML
ASND|ASND
ASNS|ASNS
ASO|ASO
ASPA|ASPA
ASPAU|ASPAU
ASPAW|ASPAW
ASPI|ASPI
ASPN|ASPN
ASPS|ASPS
ASPU|ASPU
ASPY|ASPY
ASR|ASR
ASRT|ASRT
ASRV|ASRV
ASTC|ASTC
ASTE|ASTE
ASTI|ASTI
ASTL|ASTL
ASTLW|ASTLW
ASTR|ASTR
ASTS|ASTS
ASTSW|ASTSW
ASUR|ASUR
ASX|ASX
ASXC|ASXC
ASYS|ASYS
ATA|ATA
ATA U|ATA.U
ATA WS|ATA.WS
ATAI|ATAI
ATAK|ATAK
ATAKR|ATAKR
ATAKU|ATAKU
ATAKW|ATAKW
ATAQ|ATAQ
ATAQ U|ATAQ.U
ATAT|ATAT
ATCO|ATCO
ATCO PRD|ATCOpD
ATCO PRH|ATCOpH
ATCO PRI|ATCOpI
ATCOL|ATCOL
ATCX|ATCX
ATEC|ATEC
ATEK|ATEK
ATEK U|ATEK.U
ATEK WS|ATEK.WS
ATEN|ATEN
ATER|ATER
ATEST|ATEST
ATEST A|ATEST.A
ATEST B|ATEST.B
ATEST C|ATEST.C
ATEST G|ATEST.G
ATEST H|ATEST.H
ATEST L|ATEST.L
ATEST Z|ATEST.Z
ATEX|ATEX
ATFV|ATFV
ATGE|ATGE
ATH PRA|ATHpA
ATH PRB|ATHpB
ATH PRC|ATHpC
ATH PRD|ATHpD
ATHA|ATHA
ATHE|ATHE
ATHM|ATHM
ATHX|ATHX
ATI|ATI
ATIF|ATIF
ATIP|ATIP
ATIP WS|ATIP.WS
ATKR|ATKR
ATLC|ATLC
ATLCL|ATLCL
ATLCP|ATLCP
ATLO|ATLO
ATMP|ATMP
ATNF|ATNF
ATNFW|ATNFW
ATNI|ATNI
ATNM|ATNM
ATNX|ATNX
ATO|ATO
ATOM|ATOM
ATOS|ATOS
ATR|ATR
ATRA|ATRA
ATRC|ATRC
ATRI|ATRI
ATRO|ATRO
ATSG|ATSG
ATTO|ATTO
ATUS|ATUS
ATVI|ATVI
ATXG|ATXG
ATXI|ATXI
ATXS|ATXS
ATY|ATY
AU|AU
AUB|AUB
AUBAP|AUBAP
AUBN|AUBN
AUD|AUD
AUDC|AUDC
AUGX|AUGX
AUGZ|AUGZ
AUID|AUID
AUMN|AUMN
AUPH|AUPH
AUR|AUR
AURA|AURA
AURC|AURC
AURCU|AURCU
AURCW|AURCW
AUROW|AUROW
AUSF|AUSF
AUST|AUST
AUTL|AUTL
AUUD|AUUD
AUUDW|AUUDW
AUVI|AUVI
AUVIP|AUVIP
AUY|AUY
AVA|AVA
AVAC|AVAC
AVACU|AVACU
AVACW|AVACW
AVAH|AVAH
AVAL|AVAL
AVAV|AVAV
AVB|AVB
AVCT|AVCT
AVCTW|AVCTW
AVD|AVD
AVDE|AVDE
AVDL|AVDL
AVDV|AVDV
AVDX|AVDX
AVEM|AVEM
AVEO|AVEO
AVES|AVES
AVGE|AVGE
AVGO|AVGO
AVGR|AVGR
AVHI|AVHI
AVHIU|AVHIU
AVHIW|AVHIW
AVID|AVID
AVIE|AVIE
AVIG|AVIG
AVIR|AVIR
AVIV|AVIV
AVK|AVK
AVLV|AVLV
AVMU|AVMU
AVNS|AVNS
AVNT|AVNT
AVNW|AVNW
AVO|AVO
AVPT|AVPT
AVPTW|AVPTW
AVRE|AVRE
AVRO|AVRO
AVSC|AVSC
AVSD|AVSD
AVSE|AVSE
AVSF|AVSF
AVSU|AVSU
AVT|AVT
AVTE|AVTE
AVTR|AVTR
AVTX|AVTX
AVUS|AVUS
AVUV|AVUV
AVXL|AVXL
AVY|AVY
AVYA|AVYA
AWAY|AWAY
AWF|AWF
AWH|AWH
AWI|AWI
AWK|AWK
AWP|AWP
AWR|AWR
AWRE|AWRE
AWX|AWX
AWYX|AWYX
AX|AX
AXAC|AXAC
AXAC RT|AXACr
AXAC WS|AXAC.WS
AXDX|AXDX
AXGN|AXGN
AXL|AXL
AXLA|AXLA
AXNX|AXNX
AXON|AXON
AXP|AXP
AXR|AXR
AXS|AXS
AXS PRE|AXSpE
AXSM|AXSM
AXTA|AXTA
AXTI|AXTI
AY|AY
AYI|AYI
AYLA|AYLA
AYRO|AYRO
AYTU|AYTU
AYX|AYX
AZ|AZ
AZEK|AZEK
AZN|AZN
AZO|AZO
AZPN|AZPN
AZRE|AZRE
AZTA|AZTA
AZTD|AZTD
AZUL|AZUL
AZYO|AZYO
AZZ|AZZ
B|B
BA|BA
BAB|BAB
BABA|BABA
BAC|BAC
BAC PRB|BACpB
BAC PRE|BACpE
BAC PRK|BACpK
BAC PRL|BACpL
BAC PRM|BACpM
BAC PRN|BACpN
BAC PRO|BACpO
BAC PRP|BACpP
BAC PRQ|BACpQ
BAC PRS|BACpS
BACA|BACA
BACA U|BACA.U
BACA WS|BACA.WS
BACK|BACK
BAD|BAD
BAFN|BAFN
BAH|BAH
BAK|BAK
BAL|BAL
BALL|BALL
BALT|BALT
BALY|BALY
BAM|BAM
BAM WI|BAMw
BAMH|BAMH
BAMI|BAMI
BAMR|BAMR
BANC|BANC
BAND|BAND
BANF|BANF
BANFP|BANFP
BANR|BANR
BANX|BANX
BAOS|BAOS
BAP|BAP
BAPR|BAPR
BAR|BAR
BARK|BARK
BARK WS|BARK.WS
BASE|BASE
BATL|BATL
BATRA|BATRA
BATRK|BATRK
BATT|BATT
BAUG|BAUG
BAX|BAX
BB|BB
BBAI|BBAI
BBAI WS|BBAI.WS
BBAR|BBAR
BBAX|BBAX
BBBY|BBBY
BBC|BBC
BBCA|BBCA
BBCP|BBCP
BBD|BBD
BBDC|BBDC
BBDO|BBDO
BBEU|BBEU
BBGI|BBGI
BBH|BBH
BBIG|BBIG
BBIN|BBIN
BBIO|BBIO
BBJP|BBJP
BBLG|BBLG
BBLGW|BBLGW
BBLN|BBLN
BBLU|BBLU
BBMC|BBMC
BBN|BBN
BBP|BBP
BBRE|BBRE
BBSA|BBSA
BBSC|BBSC
BBSI|BBSI
BBU|BBU
BBUC|BBUC
BBUS|BBUS
BBVA|BBVA
BBW|BBW
BBWI|BBWI
BBY|BBY
BC|BC
BC PRA|BCpA
BC PRB|BCpB
BC PRC|BCpC
BCAB|BCAB
BCAN|BCAN
BCAT|BCAT
BCBP|BCBP
BCC|BCC
BCD|BCD
BCDA|BCDA
BCDAW|BCDAW
BCDF|BCDF
BCE|BCE
BCEL|BCEL
BCH|BCH
BCI|BCI
BCIM|BCIM
BCLI|BCLI
BCM|BCM
BCML|BCML
BCO|BCO
BCOR|BCOR
BCOV|BCOV
BCOW|BCOW
BCPC|BCPC
BCRX|BCRX
BCS|BCS
BCSA|BCSA
BCSAU|BCSAU
BCSAW|BCSAW
BCSF|BCSF
BCTX|BCTX
BCTXW|BCTXW
BCV|BCV
BCV PRA|BCVpA
BCX|BCX
BCYC|BCYC
BDC|BDC
BDCX|BDCX
BDCZ|BDCZ
BDEC|BDEC
BDJ|BDJ
BDL|BDL
BDN|BDN
BDRY|BDRY
BDSX|BDSX
BDTX|BDTX
BDX|BDX
BDXB|BDXB
BE|BE
BEAM|BEAM
BEAT|BEAT
BEATW|BEATW
BECN|BECN
BECO|BECO
BEDU|BEDU
BEDZ|BEDZ
BEEM|BEEM
BEEMW|BEEMW
BEKE|BEKE
BELFA|BELFA
BELFB|BELFB
BEN|BEN
BEP|BEP
BEP PRA|BEPpA
BEPC|BEPC
BEPH|BEPH
BEPI|BEPI
BERY|BERY
BERZ|BERZ
BEST|BEST
BETZ|BETZ
BF A|BF.A
BF B|BF.B
BFAC|BFAC
BFAC U|BFAC.U
BFAC WS|BFAC.WS
BFAM|BFAM
BFC|BFC
BFEB|BFEB
BFH|BFH
BFI|BFI
BFIIW|BFIIW
BFIN|BFIN
BFIT|BFIT
BFIX|BFIX
BFK|BFK
BFLY|BFLY
BFLY WS|BFLY.WS
BFOR|BFOR
BFRI|BFRI
BFRIW|BFRIW
BFS|BFS
BFS PRD|BFSpD
BFS PRE|BFSpE
BFST|BFST
BFTR|BFTR
BFZ|BFZ
BG|BG
BGB|BGB
BGCP|BGCP
BGFV|BGFV
BGH|BGH
BGI|BGI
BGLD|BGLD
BGNE|BGNE
BGR|BGR
BGRN|BGRN
BGRY|BGRY
BGRYW|BGRYW
BGS|BGS
BGSF|BGSF
BGSX|BGSX
BGSX U|BGSX.U
BGSX WS|BGSX.WS
BGT|BGT
BGX|BGX
BGXX|BGXX
BGY|BGY
BH|BH
BH A|BH.A
BHAC|BHAC
BHACU|BHACU
BHACW|BHACW
BHAT|BHAT
BHB|BHB
BHC|BHC
BHE|BHE
BHF|BHF
BHFAL|BHFAL
BHFAM|BHFAM
BHFAN|BHFAN
BHFAO|BHFAO
BHFAP|BHFAP
BHG|BHG
BHIL|BHIL
BHIL WS|BHIL.WS
BHK|BHK
BHLB|BHLB
BHM|BHM
BHP|BHP
BHR|BHR
BHR PRB|BHRpB
BHR PRD|BHRpD
BHV|BHV
BHVN|BHVN
BIAF|BIAF
BIAFW|BIAFW
BIB|BIB
BIBL|BIBL
BICK|BICK
BIDS|BIDS
BIDU|BIDU
BIG|BIG
BIGC|BIGC
BIGZ|BIGZ
BIIB|BIIB
BIL|BIL
BILI|BILI
BILL|BILL
BILS|BILS
BIMI|BIMI
BIO|BIO
BIO B|BIO.B
BIOC|BIOC
BIOL|BIOL
BIOR|BIOR
BIOS|BIOS
BIOSU|BIOSU
BIOSW|BIOSW
BIOT|BIOT
BIOTU|BIOTU
BIOTW|BIOTW
BIOX|BIOX
BIP|BIP
BIP PRA|BIPpA
BIP PRB|BIPpB
BIPC|BIPC
BIPH|BIPH
BIPI|BIPI
BIRD|BIRD
BIS|BIS
BIT|BIT
BITE|BITE
BITE U|BITE.U
BITE WS|BITE.WS
BITF|BITF
BITI|BITI
BITO|BITO
BITQ|BITQ
BITS|BITS
BIV|BIV
BIVI|BIVI
BIZD|BIZD
BJ|BJ
BJAN|BJAN
BJDX|BJDX
BJK|BJK
BJRI|BJRI
BJUL|BJUL
BJUN|BJUN
BK|BK
BKAG|BKAG
BKCC|BKCC
BKCH|BKCH
BKCI|BKCI
BKD|BKD
BKDT|BKDT
BKE|BKE
BKEM|BKEM
BKES|BKES
BKF|BKF
BKGI|BKGI
BKH|BKH
BKHY|BKHY
BKI|BKI
BKIE|BKIE
BKIS|BKIS
BKKT|BKKT
BKKT WS|BKKT.WS
BKLC|BKLC
BKLN|BKLN
BKMC|BKMC
BKN|BKN
BKNG|BKNG
BKR|BKR
BKSB|BKSB
BKSC|BKSC
BKSE|BKSE
BKSY|BKSY
BKSY WS|BKSY.WS
BKT|BKT
BKTI|BKTI
BKU|BKU
BKUI|BKUI
BKUS|BKUS
BKYI|BKYI
BL|BL
BLBD|BLBD
BLBX|BLBX
BLCM|BLCM
BLCN|BLCN
BLCO|BLCO
BLD|BLD
BLDE|BLDE
BLDEW|BLDEW
BLDG|BLDG
BLDP|BLDP
BLDR|BLDR
BLE|BLE
BLES|BLES
BLEU|BLEU
BLEUR|BLEUR
BLEUU|BLEUU
BLEUW|BLEUW
BLFS|BLFS
BLFY|BLFY
BLHY|BLHY
BLI|BLI
BLIN|BLIN
BLK|BLK
BLKB|BLKB
BLKC|BLKC
BLLD|BLLD
BLMN|BLMN
BLND|BLND
BLNG|BLNG
BLNGU|BLNGU
BLNGW|BLNGW
BLNK|BLNK
BLNKW|BLNKW
BLOK|BLOK
BLPH|BLPH
BLRX|BLRX
BLTE|BLTE
BLTS|BLTS
BLTSU|BLTSU
BLTSW|BLTSW
BLU|BLU
BLUA|BLUA
BLUA U|BLUA.U
BLUA WS|BLUA.WS
BLUE|BLUE
BLV|BLV
BLW|BLW
BLX|BLX
BLZE|BLZE
BMA|BMA
BMAC|BMAC
BMAC U|BMAC.U
BMAC WS|BMAC.WS
BMAQ|BMAQ
BMAQR|BMAQR
BMAQU|BMAQU
BMAQW|BMAQW
BMAR|BMAR
BMAY|BMAY
BMBL|BMBL
BME|BME
BMEA|BMEA
BMED|BMED
BMEZ|BMEZ
BMI|BMI
BML PRG|BMLpG
BML PRH|BMLpH
BML PRJ|BMLpJ
BML PRL|BMLpL
BMN|BMN
BMO|BMO
BMRA|BMRA
BMRC|BMRC
BMRN|BMRN
BMTX|BMTX
BMTX WS|BMTX.WS
BMY|BMY
BN WI|BNw
BND|BND
BNDC|BNDC
BNDD|BNDD
BNDI|BNDI
BNDW|BNDW
BNDX|BNDX
BNE|BNE
BNED|BNED
BNFT|BNFT
BNGE|BNGE
BNGO|BNGO
BNGOW|BNGOW
BNIX|BNIX
BNIXR|BNIXR
BNIXW|BNIXW
BNKD|BNKD
BNKU|BNKU
BNL|BNL
BNNR|BNNR
BNNRU|BNNRU
BNNRW|BNNRW
BNO|BNO
BNOV|BNOV
BNOX|BNOX
BNR|BNR
BNRG|BNRG
BNS|BNS
BNSO|BNSO
BNTC|BNTC
BNTX|BNTX
BNY|BNY
BOAC|BOAC
BOAC U|BOAC.U
BOAC WS|BOAC.WS
BOAT|BOAT
BOC|BOC
BOCN|BOCN
BOCNU|BOCNU
BOCNW|BOCNW
BOCT|BOCT
BODY|BODY
BODY WS|BODY.WS
BOE|BOE
BOH|BOH
BOH PRA|BOHpA
BOIL|BOIL
BOKF|BOKF
BOLT|BOLT
BON|BON
BOND|BOND
BOOM|BOOM
BOOT|BOOT
BORR|BORR
BOSC|BOSC
BOSS|BOSS
BOTJ|BOTJ
BOTZ|BOTZ
BOUT|BOUT
BOWL|BOWL
BOX|BOX
BOXD|BOXD
BOXD WS|BOXD.WS
BOXL|BOXL
BP|BP
BPAC|BPAC
BPACU|BPACU
BPACW|BPACW
BPAY|BPAY
BPMC|BPMC
BPOP|BPOP
BPOPM|BPOPM
BPRN|BPRN
BPT|BPT
BPTH|BPTH
BPTS|BPTS
BPYPM|BPYPM
BPYPN|BPYPN
BPYPO|BPYPO
BPYPP|BPYPP
BQ|BQ
BR|BR
BRAC|BRAC
BRACR|BRACR
BRACU|BRACU
BRAG|BRAG
BRBR|BRBR
BRBS|BRBS
BRC|BRC
BRCC|BRCC
BRD|BRD
BRD U|BRD.U
BRD WS|BRD.WS
BRDG|BRDG
BRDS|BRDS
BRDS WS|BRDS.WS
BREZ|BREZ
BREZR|BREZR
BREZW|BREZW
BRF|BRF
BRFH|BRFH
BRFS|BRFS
BRID|BRID
BRIV|BRIV
BRIVU|BRIVU
BRIVW|BRIVW
BRK A|BRK.A
BRK B|BRK.B
BRKH|BRKH
BRKHU|BRKHU
BRKHW|BRKHW
BRKL|BRKL
BRKR|BRKR
BRKY|BRKY
BRLI|BRLI
BRLIR|BRLIR
BRLIU|BRLIU
BRLIW|BRLIW
BRLN|BRLN
BRLT|BRLT
BRMK|BRMK
BRMK WS|BRMK.WS
BRN|BRN
BRNY|BRNY
BRO|BRO
BROG|BROG
BROGW|BROGW
BROS|BROS
BRP|BRP
BRQS|BRQS
BRSH|BRSH
BRSHW|BRSHW
BRSP|BRSP
BRT|BRT
BRTX|BRTX
BRW|BRW
BRX|BRX
BRY|BRY
BRZE|BRZE
BRZU|BRZU
BSAC|BSAC
BSAQ|BSAQ
BSAQ U|BSAQ.U
BSAQ WS|BSAQ.WS
BSBE|BSBE
BSBK|BSBK
BSBR|BSBR
BSCE|BSCE
BSCM|BSCM
BSCN|BSCN
BSCO|BSCO
BSCP|BSCP
BSCQ|BSCQ
BSCR|BSCR
BSCS|BSCS
BSCT|BSCT
BSCU|BSCU
BSCV|BSCV
BSCW|BSCW
BSDE|BSDE
BSEA|BSEA
BSEP|BSEP
BSET|BSET
BSFC|BSFC
BSGA|BSGA
BSGAR|BSGAR
BSGAU|BSGAU
BSGM|BSGM
BSIG|BSIG
BSJM|BSJM
BSJN|BSJN
BSJO|BSJO
BSJP|BSJP
BSJQ|BSJQ
BSJR|BSJR
BSJS|BSJS
BSJT|BSJT
BSJU|BSJU
BSKY|BSKY
BSKYU|BSKYU
BSKYW|BSKYW
BSL|BSL
BSM|BSM
BSMM|BSMM
BSMN|BSMN
BSMO|BSMO
BSMP|BSMP
BSMQ|BSMQ
BSMR|BSMR
BSMS|BSMS
BSMT|BSMT
BSMU|BSMU
BSMV|BSMV
BSMX|BSMX
BSQR|BSQR
BSRR|BSRR
BST|BST
BSTP|BSTP
BSTZ|BSTZ
BSV|BSV
BSVN|BSVN
BSX|BSX
BSX PRA|BSXpA
BSY|BSY
BTA|BTA
BTAI|BTAI
BTAL|BTAL
BTB|BTB
BTBD|BTBD
BTBDW|BTBDW
BTBT|BTBT
BTCM|BTCM
BTCR|BTCR
BTCS|BTCS
BTCY|BTCY
BTEC|BTEC
BTEK|BTEK
BTF|BTF
BTG|BTG
BTHM|BTHM
BTI|BTI
BTMD|BTMD
BTMDW|BTMDW
BTN|BTN
BTO|BTO
BTOG|BTOG
BTRS|BTRS
BTT|BTT
BTTR|BTTR
BTTX|BTTX
BTU|BTU
BTWN|BTWN
BTWNU|BTWNU
BTWNW|BTWNW
BTZ|BTZ
BUCK|BUCK
BUD|BUD
BUFB|BUFB
BUFD|BUFD
BUFF|BUFF
BUFG|BUFG
BUFQ|BUFQ
BUFR|BUFR
BUFT|BUFT
BUG|BUG
BUI|BUI
BUL|BUL
BULD|BULD
BULZ|BULZ
BUR|BUR
BURL|BURL
BUSE|BUSE
BUYW|BUYW
BUYZ|BUYZ
BUZZ|BUZZ
BV|BV
BVH|BVH
BVN|BVN
BVS|BVS
BVXV|BVXV
BW|BW
BW PRA|BWpA
BWA|BWA
BWAC|BWAC
BWACU|BWACU
BWACW|BWACW
BWAQ|BWAQ
BWAQR|BWAQR
BWAQU|BWAQU
BWAQW|BWAQW
BWAY|BWAY
BWB|BWB
BWBBP|BWBBP
BWC|BWC
BWCAU|BWCAU
BWCAW|BWCAW
BWEB|BWEB
BWEN|BWEN
BWFG|BWFG
BWG|BWG
BWMN|BWMN
BWMX|BWMX
BWNB|BWNB
BWSN|BWSN
BWV|BWV
BWX|BWX
BWXT|BWXT
BWZ|BWZ
BX|BX
BXC|BXC
BXMT|BXMT
BXMX|BXMX
BXP|BXP
BXRX|BXRX
BXSL|BXSL
BY|BY
BYD|BYD
BYFC|BYFC
BYLD|BYLD
BYM|BYM
BYN|BYN
BYN U|BYN.U
BYN WS|BYN.WS
BYND|BYND
BYNO|BYNO
BYNOU|BYNOU
BYNOW|BYNOW
BYOB|BYOB
BYRE|BYRE
BYRN|BYRN
BYSI|BYSI
BYTE|BYTE
BYTS|BYTS
BYTSU|BYTSU
BYTSW|BYTSW
BZ|BZ
BZFD|BZFD
BZFDW|BZFDW
BZH|BZH
BZQ|BZQ
BZUN|BZUN
C|C
C PRJ|CpJ
C PRK|CpK
C PRN|CpN
CAAP|CAAP
CAAS|CAAS
CABA|CABA
CABO|CABO
CAC|CAC
CACC|CACC
CACG|CACG
CACI|CACI
CADE|CADE
CADE PRA|CADEpA
CADL|CADL
CAE|CAE
CAF|CAF
CAG|CAG
CAH|CAH
CAJ|CAJ
CAKE|CAKE
CAL|CAL
CALA|CALA
CALB|CALB
CALF|CALF
CALM|CALM
CALT|CALT
CALX|CALX
CAMP|CAMP
CAMT|CAMT
CAN|CAN
CANE|CANE
CANF|CANF
CANG|CANG
CANO|CANO
CANO WS|CANO.WS
CAPE|CAPE
CAPL|CAPL
CAPR|CAPR
CAR|CAR
CARA|CARA
CARE|CARE
CARG|CARG
CARR|CARR
CARS|CARS
CARV|CARV
CARY|CARY
CARZ|CARZ
CASA|CASA
CASH|CASH
CASI|CASI
CASS|CASS
CASY|CASY
CAT|CAT
CATC|CATC
CATH|CATH
CATO|CATO
CATY|CATY
CB|CB
CBAN|CBAN
CBAT|CBAT
CBAY|CBAY
CBD|CBD
CBFV|CBFV
CBH|CBH
CBIO|CBIO
CBL|CBL
CBLS|CBLS
CBNK|CBNK
CBO|CBO
CBO PRA|CBOpA
CBOE|CBOE
CBON|CBON
CBRE|CBRE
CBRG|CBRG
CBRGU|CBRGU
CBRGW|CBRGW
CBRL|CBRL
CBSE|CBSE
CBSH|CBSH
CBT|CBT
CBU|CBU
CBX|CBX
CBZ|CBZ
CC|CC
CCAI|CCAI
CCAIU|CCAIU
CCAIW|CCAIW
CCAP|CCAP
CCB|CCB
CCBG|CCBG
CCCC|CCCC
CCCS|CCCS
CCD|CCD
CCEL|CCEL
CCEP|CCEP
CCF|CCF
CCI|CCI
CCJ|CCJ
CCK|CCK
CCL|CCL
CCLP|CCLP
CCM|CCM
CCNC|CCNC
CCNE|CCNE
CCNEP|CCNEP
CCO|CCO
CCOI|CCOI
CCOR|CCOR
CCRD|CCRD
CCRN|CCRN
CCRV|CCRV
CCS|CCS
CCSI|CCSI
CCSO|CCSO
CCTS|CCTS
CCTSU|CCTSU
CCTSW|CCTSW
CCU|CCU
CCV|CCV
CCV U|CCV.U
CCV WS|CCV.WS
CCVI|CCVI
CCVI U|CCVI.U
CCVI WS|CCVI.WS
CCZ|CCZ
CD|CD
CDAK|CDAK
CDAQ|CDAQ
CDAQU|CDAQU
CDAQW|CDAQW
CDAY|CDAY
CDC|CDC
CDE|CDE
CDIO|CDIO
CDIOW|CDIOW
CDL|CDL
CDLX|CDLX
CDMO|CDMO
CDNA|CDNA
CDNS|CDNS
CDR PRB|CDRpB
CDR PRC|CDRpC
CDRE|CDRE
CDRO|CDRO
CDROW|CDROW
CDTX|CDTX
CDW|CDW
CDX|CDX
CDXC|CDXC
CDXS|CDXS
CDZI|CDZI
CDZIP|CDZIP
CE|CE
CEA|CEA
CEAD|CEAD
CEADW|CEADW
CECO|CECO
CEE|CEE
CEF|CEF
CEFA|CEFA
CEFD|CEFD
CEFS|CEFS
CEG|CEG
CEI|CEI
CEIX|CEIX
CELC|CELC
CELG RT|CELGr
CELH|CELH
CELU|CELU
CELUW|CELUW
CELZ|CELZ
CEM|CEM
CEMB|CEMB
CEMI|CEMI
CEN|CEN
CENN|CENN
CENQ|CENQ
CENQU|CENQU
CENQW|CENQW
CENT|CENT
CENTA|CENTA
CENX|CENX
CEPU|CEPU
CEQP|CEQP
CEQP PR|CEQPp
CERE|CERE
CERS|CERS
CERT|CERT
CET|CET
CETX|CETX
CETXP|CETXP
CEV|CEV
CEVA|CEVA
CEW|CEW
CEY|CEY
CF|CF
CFA|CFA
CFB|CFB
CFBK|CFBK
CFCV|CFCV
CFFE|CFFE
CFFEU|CFFEU
CFFEW|CFFEW
CFFI|CFFI
CFFN|CFFN
CFFS|CFFS
CFFSU|CFFSU
CFFSW|CFFSW
CFG|CFG
CFG PRD|CFGpD
CFG PRE|CFGpE
CFIV|CFIV
CFIVU|CFIVU
CFIVW|CFIVW
CFLT|CFLT
CFMS|CFMS
CFO|CFO
CFR|CFR
CFR PRB|CFRpB
CFRX|CFRX
CFSB|CFSB
CG|CG
CGA|CGA
CGABL|CGABL
CGAU|CGAU
CGBD|CGBD
CGC|CGC
CGCP|CGCP
CGDV|CGDV
CGEM|CGEM
CGEN|CGEN
CGGO|CGGO
CGGR|CGGR
CGMS|CGMS
CGMU|CGMU
CGNT|CGNT
CGNX|CGNX
CGO|CGO
CGRN|CGRN
CGSD|CGSD
CGTX|CGTX
CGUS|CGUS
CGV|CGV
CGW|CGW
CGXU|CGXU
CHAA|CHAA
CHAA U|CHAA.U
CHAD|CHAD
CHAU|CHAU
CHB|CHB
CHCI|CHCI
CHCO|CHCO
CHCT|CHCT
CHD|CHD
CHDN|CHDN
CHE|CHE
CHEA|CHEA
CHEAU|CHEAU
CHEAW|CHEAW
CHEF|CHEF
CHEK|CHEK
CHEKZ|CHEKZ
CHGG|CHGG
CHGX|CHGX
CHH|CHH
CHI|CHI
CHIC|CHIC
CHIE|CHIE
CHIH|CHIH
CHII|CHII
CHIK|CHIK
CHIM|CHIM
CHIQ|CHIQ
CHIR|CHIR
CHIS|CHIS
CHIU|CHIU
CHIX|CHIX
CHK|CHK
CHKEL|CHKEL
CHKEW|CHKEW
CHKEZ|CHKEZ
CHKP|CHKP
CHMG|CHMG
CHMI|CHMI
CHMI PRA|CHMIpA
CHMI PRB|CHMIpB
CHN|CHN
CHNA|CHNA
CHNR|CHNR
CHPT|CHPT
CHRA|CHRA
CHRB|CHRB
CHRD|CHRD
CHRS|CHRS
CHRW|CHRW
CHS|CHS
CHSCL|CHSCL
CHSCM|CHSCM
CHSCN|CHSCN
CHSCO|CHSCO
CHSCP|CHSCP
CHT|CHT
CHTR|CHTR
CHUY|CHUY
CHW|CHW
CHWY|CHWY
CHX|CHX
CHY|CHY
CI|CI
CIA|CIA
CIAN|CIAN
CIB|CIB
CIBR|CIBR
CID|CID
CIDM|CIDM
CIEN|CIEN
CIF|CIF
CIFR|CIFR
CIFRW|CIFRW
CIG|CIG
CIG C|CIG.C
CIGI|CIGI
CIH|CIH
CII|CII
CIIG|CIIG
CIIGU|CIIGU
CIIGW|CIIGW
CIK|CIK
CIL|CIL
CIM|CIM
CIM PRA|CIMpA
CIM PRB|CIMpB
CIM PRC|CIMpC
CIM PRD|CIMpD
CINC|CINC
CINF|CINF
CING|CING
CINGW|CINGW
CINT|CINT
CIO|CIO
CIO PRA|CIOpA
CION|CION
CIR|CIR
CIRC|CIRC
CISO|CISO
CITE|CITE
CITEU|CITEU
CITEW|CITEW
CIVB|CIVB
CIVI|CIVI
CIX|CIX
CIXX|CIXX
CIZ|CIZ
CIZN|CIZN
CJJD|CJJD
CKPT|CKPT
CKX|CKX
CL|CL
CLAA|CLAA
CLAA U|CLAA.U
CLAA WS|CLAA.WS
CLAR|CLAR
CLAS|CLAS
CLAS U|CLAS.U
CLAS WS|CLAS.WS
CLAY|CLAY
CLAYU|CLAYU
CLAYW|CLAYW
CLB|CLB
CLBK|CLBK
CLBR|CLBR
CLBR U|CLBR.U
CLBR WS|CLBR.WS
CLBT|CLBT
CLBTW|CLBTW
CLDL|CLDL
CLDT|CLDT
CLDT PRA|CLDTpA
CLDX|CLDX
CLEU|CLEU
CLF|CLF
CLFD|CLFD
CLGN|CLGN
CLH|CLH
CLIM|CLIM
CLIM U|CLIM.U
CLIN|CLIN
CLINR|CLINR
CLINU|CLINU
CLINW|CLINW
CLIR|CLIR
CLIX|CLIX
CLLS|CLLS
CLM|CLM
CLMB|CLMB
CLMT|CLMT
CLNE|CLNE
CLNN|CLNN
CLNNW|CLNNW
CLNR|CLNR
CLOE|CLOE
CLOER|CLOER
CLOEU|CLOEU
CLOI|CLOI
CLOU|CLOU
CLOV|CLOV
CLPR|CLPR
CLPS|CLPS
CLPT|CLPT
CLRB|CLRB
CLRC|CLRC
CLRCR|CLRCR
CLRCU|CLRCU
CLRCW|CLRCW
CLRG|CLRG
CLRM|CLRM
CLRMU|CLRMU
CLRMW|CLRMW
CLRO|CLRO
CLS|CLS
CLSA|CLSA
CLSC|CLSC
CLSD|CLSD
CLSE|CLSE
CLSK|CLSK
CLSM|CLSM
CLST|CLST
CLTL|CLTL
CLVR|CLVR
CLVRW|CLVRW
CLVS|CLVS
CLVT|CLVT
CLVT PRA|CLVTpA
CLW|CLW
CLWT|CLWT
CLX|CLX
CLXT|CLXT
CM|CM
CMA|CMA
CMAX|CMAX
CMAXW|CMAXW
CMBM|CMBM
CMBS|CMBS
CMC|CMC
CMCA|CMCA
CMCAU|CMCAU
CMCAW|CMCAW
CMCL|CMCL
CMCM|CMCM
CMCO|CMCO
CMCSA|CMCSA
CMCT|CMCT
CMCTP|CMCTP
CMDY|CMDY
CME|CME
CMF|CMF
CMG|CMG
CMI|CMI
CMLS|CMLS
CMMB|CMMB
CMND|CMND
CMP|CMP
CMPO|CMPO
CMPOW|CMPOW
CMPR|CMPR
CMPS|CMPS
CMPX|CMPX
CMRA|CMRA
CMRAW|CMRAW
CMRE|CMRE
CMRE PRB|CMREpB
CMRE PRC|CMREpC
CMRE PRD|CMREpD
CMRE PRE|CMREpE
CMRX|CMRX
CMS|CMS
CMS PRB|CMSpB
CMS PRC|CMSpC
CMSA|CMSA
CMSC|CMSC
CMSD|CMSD
CMT|CMT
CMTG|CMTG
CMTL|CMTL
CMU|CMU
CN|CN
CNA|CNA
CNBS|CNBS
CNC|CNC
CNCE|CNCE
CNCR|CNCR
CND|CND
CND U|CND.U
CND WS|CND.WS
CNDA|CNDA
CNDA U|CNDA.U
CNDA WS|CNDA.WS
CNDB|CNDB
CNDB U|CNDB.U
CNDB WS|CNDB.WS
CNDT|CNDT
CNET|CNET
CNEY|CNEY
CNF|CNF
CNFR|CNFR
CNFRL|CNFRL
CNGL|CNGL
CNGLU|CNGLU
CNGLW|CNGLW
CNHI|CNHI
CNI|CNI
CNK|CNK
CNM|CNM
CNMD|CNMD
CNNB|CNNB
CNNE|CNNE
CNO|CNO
CNO PRA|CNOpA
CNOB|CNOB
CNOBP|CNOBP
CNP|CNP
CNQ|CNQ
CNRG|CNRG
CNS|CNS
CNSL|CNSL
CNSP|CNSP
CNTA|CNTA
CNTB|CNTB
CNTG|CNTG
CNTX|CNTX
CNTY|CNTY
CNX|CNX
CNXA|CNXA
CNXC|CNXC
CNXN|CNXN
CNXT|CNXT
CNYA|CNYA
CO|CO
COCO|COCO
COCP|COCP
CODA|CODA
CODI|CODI
CODI PRA|CODIpA
CODI PRB|CODIpB
CODI PRC|CODIpC
CODX|CODX
COE|COE
COEP|COEP
COEPW|COEPW
COF|COF
COF PRI|COFpI
COF PRJ|COFpJ
COF PRK|COFpK
COF PRL|COFpL
COF PRN|COFpN
COFS|COFS
COGT|COGT
COHN|COHN
COHR|COHR
COHU|COHU
COIN|COIN
COKE|COKE
COLB|COLB
COLD|COLD
COLI|COLI
COLIU|COLIU
COLIW|COLIW
COLL|COLL
COLM|COLM
COM|COM
COMB|COMB
COMM|COMM
COMP|COMP
COMS|COMS
COMSP|COMSP
COMSW|COMSW
COMT|COMT
CONL|CONL
CONN|CONN
CONX|CONX
CONXU|CONXU
CONXW|CONXW
COO|COO
COOK|COOK
COOL|COOL
COOLU|COOLU
COOLW|COOLW
COOP|COOP
COP|COP
COPX|COPX
CORN|CORN
CORP|CORP
CORR|CORR
CORR PRA|CORRpA
CORS|CORS
CORS U|CORS.U
CORS WS|CORS.WS
CORT|CORT
CORZ|CORZ
CORZW|CORZW
COSM|COSM
COST|COST
COTY|COTY
COUP|COUP
COUR|COUR
COVA|COVA
COVAU|COVAU
COVAW|COVAW
COW|COW
COWN|COWN
COWNL|COWNL
COWZ|COWZ
CP|CP
CPA|CPA
CPAA|CPAA
CPAAU|CPAAU
CPAAW|CPAAW
CPAC|CPAC
CPAQ|CPAQ
CPAQU|CPAQU
CPAQW|CPAQW
CPAR|CPAR
CPARU|CPARU
CPARW|CPARW
CPB|CPB
CPE|CPE
CPER|CPER
CPF|CPF
CPG|CPG
CPHC|CPHC
CPHI|CPHI
CPI|CPI
CPII|CPII
CPIX|CPIX
CPK|CPK
CPLP|CPLP
CPNG|CPNG
CPOP|CPOP
CPRI|CPRI
CPRT|CPRT
CPRX|CPRX
CPS|CPS
CPSH|CPSH
CPSI|CPSI
CPSS|CPSS
CPT|CPT
CPTK|CPTK
CPTK U|CPTK.U
CPTN|CPTN
CPTNW|CPTNW
CPUH|CPUH
CPUH U|CPUH.U
CPUH WS|CPUH.WS
CPZ|CPZ
CQP|CQP
CQQQ|CQQQ
CR|CR
CRAI|CRAI
CRAK|CRAK
CRBG|CRBG
CRBN|CRBN
CRBP|CRBP
CRBU|CRBU
CRC|CRC
CRCT|CRCT
CRD A|CRD.A
CRD B|CRD.B
CRDF|CRDF
CRDL|CRDL
CRDO|CRDO
CREC|CREC
CRECU|CRECU
CRECW|CRECW
CREG|CREG
CRESW|CRESW
CRESY|CRESY
CREX|CREX
CREXW|CREXW
CRF|CRF
CRGE|CRGE
CRGY|CRGY
CRH|CRH
CRI|CRI
CRIS|CRIS
CRIT|CRIT
CRK|CRK
CRKN|CRKN
CRL|CRL
CRM|CRM
CRMD|CRMD
CRMT|CRMT
CRNC|CRNC
CRNT|CRNT
CRNX|CRNX
CRON|CRON
CROX|CROX
CRPT|CRPT
CRS|CRS
CRSP|CRSP
CRSR|CRSR
CRT|CRT
CRTO|CRTO
CRUS|CRUS
CRUZ|CRUZ
CRVL|CRVL
CRVS|CRVS
CRWD|CRWD
CRWS|CRWS
CRYP|CRYP
CRZN|CRZN
CRZNU|CRZNU
CRZNW|CRZNW
CS|CS
CSA|CSA
CSAN|CSAN
CSB|CSB
CSBR|CSBR
CSCO|CSCO
CSD|CSD
CSF|CSF
CSGP|CSGP
CSGS|CSGS
CSH|CSH
CSHI|CSHI
CSII|CSII
CSIQ|CSIQ
CSL|CSL
CSLM|CSLM
CSLMR|CSLMR
CSLMU|CSLMU
CSLMW|CSLMW
CSM|CSM
CSML|CSML
CSPI|CSPI
CSQ|CSQ
CSR|CSR
CSR PRC|CSRpC
CSSE|CSSE
CSSEL|CSSEL
CSSEN|CSSEN
CSSEP|CSSEP
CSTA|CSTA
CSTA U|CSTA.U
CSTA WS|CSTA.WS
CSTE|CSTE
CSTL|CSTL
CSTM|CSTM
CSTR|CSTR
CSV|CSV
CSWC|CSWC
CSWI|CSWI
CSX|CSX
CTA|CTA
CTA PRA|CTApA
CTA PRB|CTApB
CTAQ|CTAQ
CTAQU|CTAQU
CTAQW|CTAQW
CTAS|CTAS
CTBB|CTBB
CTBI|CTBI
CTDD|CTDD
CTEC|CTEC
CTEST|CTEST
CTEST A|CTEST.A
CTEX|CTEX
CTG|CTG
CTGO|CTGO
CTHR|CTHR
CTIB|CTIB
CTIC|CTIC
CTKB|CTKB
CTLP|CTLP
CTLT|CTLT
CTM|CTM
CTMX|CTMX
CTO|CTO
CTO PRA|CTOpA
CTOS|CTOS
CTOS WS|CTOS.WS
CTR|CTR
CTRA|CTRA
CTRE|CTRE
CTRM|CTRM
CTRN|CTRN
CTS|CTS
CTSH|CTSH
CTSO|CTSO
CTV|CTV
CTV WS|CTV.WS
CTVA|CTVA
CTXR|CTXR
CUBA|CUBA
CUBB|CUBB
CUBE|CUBE
CUBI|CUBI
CUBI PRE|CUBIpE
CUBI PRF|CUBIpF
CUBS|CUBS
CUE|CUE
CUEN|CUEN
CUENW|CUENW
CUK|CUK
CULL|CULL
CULP|CULP
CURE|CURE
CURI|CURI
CURIW|CURIW
CURO|CURO
CURV|CURV
CUT|CUT
CUTR|CUTR
CUZ|CUZ
CVAC|CVAC
CVAR|CVAR
CVBF|CVBF
CVCO|CVCO
CVCY|CVCY
CVE|CVE
CVE WS|CVE.WS
CVEO|CVEO
CVGI|CVGI
CVGW|CVGW
CVI|CVI
CVII|CVII
CVII U|CVII.U
CVII WS|CVII.WS
CVLG|CVLG
CVLT|CVLT
CVLY|CVLY
CVM|CVM
CVNA|CVNA
CVR|CVR
CVRX|CVRX
CVS|CVS
CVT|CVT
CVU|CVU
CVV|CVV
CVX|CVX
CVY|CVY
CW|CW
CWAN|CWAN
CWB|CWB
CWBC|CWBC
CWBR|CWBR
CWCO|CWCO
CWEB|CWEB
CWEN|CWEN
CWEN A|CWEN.A
CWH|CWH
CWI|CWI
CWK|CWK
CWS|CWS
CWST|CWST
CWT|CWT
CX|CX
CXAC|CXAC
CXAC U|CXAC.U
CXAC WS|CXAC.WS
CXDO|CXDO
CXE|CXE
CXH|CXH
CXM|CXM
CXSE|CXSE
CXW|CXW
CYA|CYA
CYAD|CYAD
CYAN|CYAN
CYB|CYB
CYBN|CYBN
CYBR|CYBR
CYCC|CYCC
CYCCP|CYCCP
CYCN|CYCN
CYD|CYD
CYH|CYH
CYN|CYN
CYRN|CYRN
CYRX|CYRX
CYT|CYT
CYTH|CYTH
CYTHW|CYTHW
CYTK|CYTK
CYTO|CYTO
CYXT|CYXT
CZA|CZA
CZFS|CZFS
CZNC|CZNC
CZOO|CZOO
CZOO WS|CZOO.WS
CZR|CZR
CZWI|CZWI
D|D
DAC|DAC
DADA|DADA
DAIO|DAIO
DAKT|DAKT
DAL|DAL
DALI|DALI
DALN|DALN
DALS|DALS
DALT|DALT
DAM|DAM
DAN|DAN
DAO|DAO
DAOO|DAOO
DAOOU|DAOOU
DAOOW|DAOOW
DAPP|DAPP
DAPR|DAPR
DAR|DAR
DARE|DARE
DASH|DASH
DAT|DAT
DATS|DATS
DATSW|DATSW
DAUG|DAUG
DAVA|DAVA
DAVE|DAVE
DAVEW|DAVEW
DAWN|DAWN
DAX|DAX
DB|DB
DBA|DBA
DBAW|DBAW
DBB|DBB
DBC|DBC
DBD|DBD
DBE|DBE
DBEF|DBEF
DBEH|DBEH
DBEM|DBEM
DBEU|DBEU
DBEZ|DBEZ
DBGI|DBGI
DBGIW|DBGIW
DBGR|DBGR
DBI|DBI
DBJA|DBJA
DBJP|DBJP
DBL|DBL
DBMF|DBMF
DBND|DBND
DBO|DBO
DBOC|DBOC
DBP|DBP
DBRG|DBRG
DBRG PRH|DBRGpH
DBRG PRI|DBRGpI
DBRG PRJ|DBRGpJ
DBS|DBS
DBTX|DBTX
DBV|DBV
DBVT|DBVT
DBX|DBX
DC|DC
DC WS|DC.WS
DCBO|DCBO
DCF|DCF
DCFC|DCFC
DCFCW|DCFCW
DCGO|DCGO
DCI|DCI
DCO|DCO
DCOM|DCOM
DCOMP|DCOMP
DCP|DCP
DCP PRB|DCPpB
DCP PRC|DCPpC
DCPH|DCPH
DCRD|DCRD
DCRDU|DCRDU
DCRDW|DCRDW
DCT|DCT
DCTH|DCTH
DD|DD
DDD|DDD
DDEC|DDEC
DDF|DDF
DDI|DDI
DDIV|DDIV
DDL|DDL
DDLS|DDLS
DDM|DDM
DDOG|DDOG
DDS|DDS
DDT|DDT
DDWM|DDWM
DE|DE
DEA|DEA
DECA|DECA
DECAU|DECAU
DECAW|DECAW
DECK|DECK
DECT|DECT
DECW|DECW
DECZ|DECZ
DEED|DEED
DEEF|DEEF
DEEP|DEEP
DEF|DEF
DEFI|DEFI
DEHP|DEHP
DEI|DEI
DEIF|DEIF
DELL|DELL
DEM|DEM
DEMZ|DEMZ
DEN|DEN
DENN|DENN
DEO|DEO
DERM|DERM
DES|DES
DESP|DESP
DEUS|DEUS
DEW|DEW
DEX|DEX
DFAC|DFAC
DFAE|DFAE
DFAI|DFAI
DFAR|DFAR
DFAS|DFAS
DFAT|DFAT
DFAU|DFAU
DFAX|DFAX
DFCF|DFCF
DFE|DFE
DFEB|DFEB
DFEM|DFEM
DFEN|DFEN
DFEV|DFEV
DFFN|DFFN
DFH|DFH
DFHY|DFHY
DFIC|DFIC
DFIN|DFIN
DFIP|DFIP
DFIS|DFIS
DFIV|DFIV
DFJ|DFJ
DFLI|DFLI
DFLIW|DFLIW
DFND|DFND
DFNL|DFNL
DFNM|DFNM
DFNV|DFNV
DFP|DFP
DFRA|DFRA
DFS|DFS
DFSB|DFSB
DFSD|DFSD
DFSE|DFSE
DFSI|DFSI
DFSU|DFSU
DFSV|DFSV
DFUS|DFUS
DFUV|DFUV
DG|DG
DGHI|DGHI
DGICA|DGICA
DGICB|DGICB
DGII|DGII
DGIN|DGIN
DGL|DGL
DGLY|DGLY
DGNU|DGNU
DGP|DGP
DGRE|DGRE
DGRO|DGRO
DGRS|DGRS
DGRW|DGRW
DGS|DGS
DGT|DGT
DGX|DGX
DGZ|DGZ
DH|DH
DHAC|DHAC
DHACU|DHACU
DHACW|DHACW
DHBC|DHBC
DHBCU|DHBCU
DHBCW|DHBCW
DHC|DHC
DHCA|DHCA
DHCAU|DHCAU
DHCAW|DHCAW
DHCNI|DHCNI
DHCNL|DHCNL
DHF|DHF
DHHC|DHHC
DHHCU|DHHCU
DHHCW|DHHCW
DHI|DHI
DHIL|DHIL
DHR|DHR
DHR PRB|DHRpB
DHS|DHS
DHT|DHT
DHX|DHX
DHY|DHY
DIA|DIA
DIAL|DIAL
DIAX|DIAX
DIBS|DIBS
DICE|DICE
DIEM|DIEM
DIG|DIG
DIHP|DIHP
DILA|DILA
DILAU|DILAU
DILAW|DILAW
DIM|DIM
DIN|DIN
DINO|DINO
DINT|DINT
DIOD|DIOD
DIS|DIS
DISA|DISA
DISAU|DISAU
DISAW|DISAW
DISH|DISH
DISV|DISV
DIT|DIT
DIV|DIV
DIVB|DIVB
DIVD|DIVD
DIVI|DIVI
DIVO|DIVO
DIVS|DIVS
DIVZ|DIVZ
DJAN|DJAN
DJCB|DJCB
DJCO|DJCO
DJD|DJD
DJIA|DJIA
DJP|DJP
DJUL|DJUL
DJUN|DJUN
DK|DK
DKDCA|DKDCA
DKDCU|DKDCU
DKDCW|DKDCW
DKL|DKL
DKNG|DKNG
DKS|DKS
DLA|DLA
DLB|DLB
DLCA|DLCA
DLCAU|DLCAU
DLCAW|DLCAW
DLHC|DLHC
DLN|DLN
DLNG|DLNG
DLNG PRA|DLNGpA
DLNG PRB|DLNGpB
DLO|DLO
DLPN|DLPN
DLR|DLR
DLR PRJ|DLRpJ
DLR PRK|DLRpK
DLR PRL|DLRpL
DLS|DLS
DLTH|DLTH
DLTR|DLTR
DLX|DLX
DLY|DLY
DM|DM
DMA|DMA
DMAC|DMAC
DMAQ|DMAQ
DMAQR|DMAQR
DMAR|DMAR
DMAT|DMAT
DMAY|DMAY
DMB|DMB
DMCY|DMCY
DMDV|DMDV
DMF|DMF
DMLP|DMLP
DMO|DMO
DMRC|DMRC
DMS|DMS
DMS WS|DMS.WS
DMTK|DMTK
DMXF|DMXF
DMYS|DMYS
DMYS U|DMYS.U
DMYS WS|DMYS.WS
DMYY|DMYY
DMYY U|DMYY.U
DMYY WS|DMYY.WS
DNA|DNA
DNA WS|DNA.WS
DNAB|DNAB
DNAD|DNAD
DNAY|DNAY
DNB|DNB
DNL|DNL
DNLI|DNLI
DNMR|DNMR
DNN|DNN
DNOV|DNOV
DNOW|DNOW
DNP|DNP
DNUT|DNUT
DNZ|DNZ
DNZ U|DNZ.U
DNZ WS|DNZ.WS
DO|DO
DOC|DOC
DOCN|DOCN
DOCS|DOCS
DOCT|DOCT
DOCU|DOCU
DOG|DOG
DOGZ|DOGZ
DOL|DOL
DOLE|DOLE
DOMA|DOMA
DOMA WS|DOMA.WS
DOMO|DOMO
DON|DON
DOOO|DOOO
DOOR|DOOR
DORM|DORM
DOUG|DOUG
DOV|DOV
DOW|DOW
DOX|DOX
DOYU|DOYU
DOZR|DOZR
DPCS|DPCS
DPCSU|DPCSU
DPCSW|DPCSW
DPG|DPG
DPRO|DPRO
DPSI|DPSI
DPST|DPST
DPZ|DPZ
DQ|DQ
DRAY|DRAY
DRAYU|DRAYU
DRAYW|DRAYW
DRCT|DRCT
DRCTW|DRCTW
DRD|DRD
DRH|DRH
DRH PRA|DRHpA
DRI|DRI
DRIO|DRIO
DRIP|DRIP
DRIV|DRIV
DRLL|DRLL
DRMA|DRMA
DRMAW|DRMAW
DRN|DRN
DRQ|DRQ
DRRX|DRRX
DRS|DRS
DRSK|DRSK
DRTS|DRTS
DRTSW|DRTSW
DRTT|DRTT
DRUG|DRUG
DRV|DRV
DRVN|DRVN
DS|DS
DS PRB|DSpB
DS PRC|DSpC
DS PRD|DSpD
DSAQ|DSAQ
DSAQ U|DSAQ.U
DSCF|DSCF
DSEP|DSEP
DSEY|DSEY
DSGN|DSGN
DSGR|DSGR
DSGX|DSGX
DSI|DSI
DSJA|DSJA
DSKE|DSKE
DSL|DSL
DSM|DSM
DSMC|DSMC
DSOC|DSOC
DSP|DSP
DSPC|DSPC
DSS|DSS
DSTL|DSTL
DSTX|DSTX
DSU|DSU
DSWL|DSWL
DSX|DSX
DSX PRB|DSXpB
DT|DT
DTB|DTB
DTC|DTC
DTD|DTD
DTE|DTE
DTEA|DTEA
DTEC|DTEC
DTF|DTF
DTG|DTG
DTH|DTH
DTIL|DTIL
DTLA PR|DTLAp
DTM|DTM
DTOC|DTOC
DTOCU|DTOCU
DTOCW|DTOCW
DTRE|DTRE
DTRT|DTRT
DTRTU|DTRTU
DTRTW|DTRTW
DTSS|DTSS
DTST|DTST
DTSTW|DTSTW
DTW|DTW
DUDE|DUDE
DUET|DUET
DUETU|DUETU
DUETW|DUETW
DUG|DUG
DUHP|DUHP
DUK|DUK
DUK PRA|DUKpA
DUKB|DUKB
DUNE|DUNE
DUNEU|DUNEU
DUNEW|DUNEW
DUO|DUO
DUOL|DUOL
DUOT|DUOT
DURA|DURA
DUSA|DUSA
DUSL|DUSL
DUST|DUST
DV|DV
DVA|DVA
DVAL|DVAL
DVAX|DVAX
DVLU|DVLU
DVN|DVN
DVND|DVND
DVOL|DVOL
DVY|DVY
DVYA|DVYA
DVYE|DVYE
DWAC|DWAC
DWACU|DWACU
DWACW|DWACW
DWAS|DWAS
DWAT|DWAT
DWAW|DWAW
DWCR|DWCR
DWEQ|DWEQ
DWLD|DWLD
DWM|DWM
DWMC|DWMC
DWMF|DWMF
DWSH|DWSH
DWSN|DWSN
DWUS|DWUS
DWX|DWX
DX|DX
DX PRC|DXpC
DXC|DXC
DXCM|DXCM
DXD|DXD
DXF|DXF
DXGE|DXGE
DXJ|DXJ
DXJS|DXJS
DXLG|DXLG
DXPE|DXPE
DXR|DXR
DXYN|DXYN
DY|DY
DYAI|DYAI
DYLD|DYLD
DYN|DYN
DYNF|DYNF
DYNT|DYNT
DZSI|DZSI
DZZ|DZZ
E|E
EA|EA
EAC|EAC
EACPU|EACPU
EACPW|EACPW
EAD|EAD
EAF|EAF
EAFD|EAFD
EAGG|EAGG
EAI|EAI
EAOA|EAOA
EAOK|EAOK
EAOM|EAOM
EAOR|EAOR
EAPR|EAPR
EAR|EAR
EARN|EARN
EASG|EASG
EAST|EAST
EAT|EAT
EATV|EATV
EATZ|EATZ
EB|EB
EBAC|EBAC
EBACU|EBACU
EBACW|EBACW
EBAY|EBAY
EBC|EBC
EBET|EBET
EBF|EBF
EBIX|EBIX
EBIZ|EBIZ
EBLU|EBLU
EBMT|EBMT
EBND|EBND
EBON|EBON
EBR|EBR
EBR B|EBR.B
EBS|EBS
EBTC|EBTC
EC|EC
ECAT|ECAT
ECBK|ECBK
ECC|ECC
ECC PRD|ECCpD
ECCC|ECCC
ECCV|ECCV
ECCW|ECCW
ECCX|ECCX
ECF|ECF
ECF PRA|ECFpA
ECH|ECH
ECL|ECL
ECLN|ECLN
ECNS|ECNS
ECON|ECON
ECOR|ECOR
ECOW|ECOW
ECOZ|ECOZ
ECPG|ECPG
ECVT|ECVT
ED|ED
EDAP|EDAP
EDBL|EDBL
EDBLW|EDBLW
EDC|EDC
EDD|EDD
EDEN|EDEN
EDF|EDF
EDI|EDI
EDIT|EDIT
EDIV|EDIV
EDN|EDN
EDOC|EDOC
EDOG|EDOG
EDOW|EDOW
EDR|EDR
EDRY|EDRY
EDSA|EDSA
EDTK|EDTK
EDTX|EDTX
EDTXU|EDTXU
EDTXW|EDTXW
EDU|EDU
EDUC|EDUC
EDUT|EDUT
EDV|EDV
EDZ|EDZ
EE|EE
EEA|EEA
EEFT|EEFT
EEIQ|EEIQ
EELV|EELV
EEM|EEM
EEMA|EEMA
EEMD|EEMD
EEMO|EEMO
EEMS|EEMS
EEMV|EEMV
EEMX|EEMX
EES|EES
EET|EET
EEV|EEV
EEX|EEX
EFA|EFA
EFAD|EFAD
EFAS|EFAS
EFAV|EFAV
EFAX|EFAX
EFC|EFC
EFC PRA|EFCpA
EFC PRB|EFCpB
EFG|EFG
EFHTU|EFHTU
EFIV|EFIV
EFIX|EFIX
EFNL|EFNL
EFO|EFO
EFOI|EFOI
EFR|EFR
EFRA|EFRA
EFSC|EFSC
EFSCP|EFSCP
EFSH|EFSH
EFT|EFT
EFTR|EFTR
EFTRW|EFTRW
EFU|EFU
EFV|EFV
EFX|EFX
EFXT|EFXT
EFZ|EFZ
EGAN|EGAN
EGBN|EGBN
EGF|EGF
EGGF|EGGF
EGGF U|EGGF.U
EGGF WS|EGGF.WS
EGHT|EGHT
EGIO|EGIO
EGIS|EGIS
EGLE|EGLE
EGLX|EGLX
EGO|EGO
EGP|EGP
EGPT|EGPT
EGRX|EGRX
EGY|EGY
EH|EH
EHAB|EHAB
EHC|EHC
EHI|EHI
EHTH|EHTH
EIC|EIC
EICA|EICA
EIDO|EIDO
EIG|EIG
EIGR|EIGR
EIM|EIM
EINC|EINC
EIPX|EIPX
EIRL|EIRL
EIS|EIS
EIX|EIX
EJAN|EJAN
EJH|EJH
EJUL|EJUL
EKAR|EKAR
EKG|EKG
EKSO|EKSO
EL|EL
ELA|ELA
ELAN|ELAN
ELAT|ELAT
ELBM|ELBM
ELC|ELC
ELD|ELD
ELDN|ELDN
ELEV|ELEV
ELF|ELF
ELLO|ELLO
ELMD|ELMD
ELME|ELME
ELOX|ELOX
ELP|ELP
ELQD|ELQD
ELS|ELS
ELSE|ELSE
ELTK|ELTK
ELV|ELV
ELVT|ELVT
ELYM|ELYM
ELYS|ELYS
EM|EM
EMAN|EMAN
EMB|EMB
EMBC|EMBC
EMBD|EMBD
EMBK|EMBK
EMBKW|EMBKW
EMCA|EMCA
EMCB|EMCB
EMCF|EMCF
EMCG|EMCG
EMCGR|EMCGR
EMCGU|EMCGU
EMCGW|EMCGW
EMCH|EMCH
EMCR|EMCR
EMD|EMD
EMDV|EMDV
EME|EME
EMF|EMF
EMFM|EMFM
EMFQ|EMFQ
EMGC|EMGC
EMGD|EMGD
EMGF|EMGF
EMHC|EMHC
EMHY|EMHY
EMIF|EMIF
EMKR|EMKR
EML|EML
EMLC|EMLC
EMLD|EMLD
EMLDU|EMLDU
EMLDW|EMLDW
EMLP|EMLP
EMMF|EMMF
EMN|EMN
EMNT|EMNT
EMO|EMO
EMP|EMP
EMPW|EMPW
EMQQ|EMQQ
EMR|EMR
EMSG|EMSG
EMTL|EMTL
EMTY|EMTY
EMX|EMX
EMXC|EMXC
EMXF|EMXF
EMZA|EMZA
ENB|ENB
ENBA|ENBA
ENCP|ENCP
ENCPU|ENCPU
ENCPW|ENCPW
ENER|ENER
ENERR|ENERR
ENERU|ENERU
ENERW|ENERW
ENFN|ENFN
ENFR|ENFR
ENG|ENG
ENIC|ENIC
ENJ|ENJ
ENLC|ENLC
ENLV|ENLV
ENO|ENO
ENOB|ENOB
ENOR|ENOR
ENOV|ENOV
ENPH|ENPH
ENR|ENR
ENRG|ENRG
ENS|ENS
ENSC|ENSC
ENSG|ENSG
ENSV|ENSV
ENTA|ENTA
ENTF|ENTF
ENTFU|ENTFU
ENTFW|ENTFW
ENTG|ENTG
ENTR|ENTR
ENTX|ENTX
ENTXW|ENTXW
ENV|ENV
ENVA|ENVA
ENVB|ENVB
ENVX|ENVX
ENX|ENX
ENZ|ENZ
ENZL|ENZL
EOCT|EOCT
EOCW|EOCW
EOCW U|EOCW.U
EOCW WS|EOCW.WS
EOD|EOD
EOG|EOG
EOI|EOI
EOLS|EOLS
EOS|EOS
EOSE|EOSE
EOSEW|EOSEW
EOT|EOT
EP|EP
EP PRC|EPpC
EPAC|EPAC
EPAM|EPAM
EPC|EPC
EPD|EPD
EPHE|EPHE
EPHY|EPHY
EPHYU|EPHYU
EPHYW|EPHYW
EPI|EPI
EPIX|EPIX
EPM|EPM
EPOL|EPOL
EPOW|EPOW
EPP|EPP
EPR|EPR
EPR PRC|EPRpC
EPR PRE|EPRpE
EPR PRG|EPRpG
EPRF|EPRF
EPRT|EPRT
EPS|EPS
EPSN|EPSN
EPU|EPU
EPV|EPV
EPWR|EPWR
EPWR U|EPWR.U
EQ|EQ
EQAL|EQAL
EQBK|EQBK
EQC|EQC
EQC PRD|EQCpD
EQH|EQH
EQH PRA|EQHpA
EQH PRC|EQHpC
EQHA|EQHA
EQHA U|EQHA.U
EQIX|EQIX
EQL|EQL
EQNR|EQNR
EQOP|EQOP
EQR|EQR
EQRR|EQRR
EQRX|EQRX
EQRXW|EQRXW
EQS|EQS
EQT|EQT
EQUL|EQUL
EQWL|EQWL
EQX|EQX
ERAS|ERAS
ERC|ERC
ERES|ERES
ERESU|ERESU
ERESW|ERESW
ERET|ERET
ERF|ERF
ERH|ERH
ERIC|ERIC
ERIE|ERIE
ERII|ERII
ERJ|ERJ
ERM|ERM
ERNA|ERNA
ERO|ERO
ERSX|ERSX
ERTH|ERTH
ERX|ERX
ERY|ERY
ERYP|ERYP
ES|ES
ESAB|ESAB
ESAC|ESAC
ESACU|ESACU
ESACW|ESACW
ESBA|ESBA
ESCA|ESCA
ESCR|ESCR
ESE|ESE
ESEA|ESEA
ESEB|ESEB
ESG|ESG
ESGA|ESGA
ESGB|ESGB
ESGD|ESGD
ESGE|ESGE
ESGG|ESGG
ESGN|ESGN
ESGR|ESGR
ESGRO|ESGRO
ESGRP|ESGRP
ESGS|ESGS
ESGU|ESGU
ESGV|ESGV
ESGY|ESGY
ESHY|ESHY
ESI|ESI
ESIX|ESIX
ESLT|ESLT
ESM|ESM
ESM U|ESM.U
ESM WS|ESM.WS
ESML|ESML
ESMT|ESMT
ESMV|ESMV
ESNT|ESNT
ESOA|ESOA
ESP|ESP
ESPO|ESPO
ESPR|ESPR
ESQ|ESQ
ESRT|ESRT
ESS|ESS
ESSA|ESSA
ESTA|ESTA
ESTC|ESTC
ESTE|ESTE
ESUS|ESUS
ET|ET
ET PRC|ETpC
ET PRD|ETpD
ET PRE|ETpE
ETB|ETB
ETD|ETD
ETG|ETG
ETHO|ETHO
ETI PR|ETIp
ETJ|ETJ
ETN|ETN
ETNB|ETNB
ETO|ETO
ETON|ETON
ETR|ETR
ETRN|ETRN
ETSY|ETSY
ETV|ETV
ETW|ETW
ETWO|ETWO
ETWO WS|ETWO.WS
ETX|ETX
ETY|ETY
EUCR|EUCR
EUCRU|EUCRU
EUCRW|EUCRW
EUDA|EUDA
EUDAW|EUDAW
EUDG|EUDG
EUDV|EUDV
EUFN|EUFN
EUM|EUM
EUO|EUO
EURL|EURL
EURN|EURN
EUSA|EUSA
EUSB|EUSB
EUSC|EUSC
EVA|EVA
EVAV|EVAV
EVAX|EVAX
EVBG|EVBG
EVBN|EVBN
EVC|EVC
EVCM|EVCM
EVE|EVE
EVE U|EVE.U
EVE WS|EVE.WS
EVEN|EVEN
EVER|EVER
EVEX|EVEX
EVEX WS|EVEX.WS
EVF|EVF
EVG|EVG
EVGN|EVGN
EVGO|EVGO
EVGOW|EVGOW
EVGR|EVGR
EVGRU|EVGRU
EVGRW|EVGRW
EVH|EVH
EVI|EVI
EVK|EVK
EVLO|EVLO
EVLV|EVLV
EVLVW|EVLVW
EVM|EVM
EVMT|EVMT
EVN|EVN
EVNT|EVNT
EVO|EVO
EVOJ|EVOJ
EVOJU|EVOJU
EVOJW|EVOJW
EVOK|EVOK
EVOP|EVOP
EVR|EVR
EVRG|EVRG
EVRI|EVRI
EVT|EVT
EVTC|EVTC
EVTL|EVTL
EVTL WS|EVTL.WS
EVTV|EVTV
EVV|EVV
EVX|EVX
EW|EW
EWA|EWA
EWBC|EWBC
EWC|EWC
EWCO|EWCO
EWCZ|EWCZ
EWD|EWD
EWEB|EWEB
EWG|EWG
EWGS|EWGS
EWH|EWH
EWI|EWI
EWJ|EWJ
EWJV|EWJV
EWK|EWK
EWL|EWL
EWM|EWM
EWMC|EWMC
EWN|EWN
EWO|EWO
EWP|EWP
EWQ|EWQ
EWRE|EWRE
EWS|EWS
EWSC|EWSC
EWT|EWT
EWTX|EWTX
EWU|EWU
EWUS|EWUS
EWV|EWV
EWW|EWW
EWX|EWX
EWY|EWY
EWZ|EWZ
EWZS|EWZS
EXAI|EXAI
EXAS|EXAS
EXC|EXC
EXD|EXD
EXEL|EXEL
EXFY|EXFY
EXG|EXG
EXI|EXI
EXK|EXK
EXLS|EXLS
EXN|EXN
EXP|EXP
EXPD|EXPD
EXPE|EXPE
EXPI|EXPI
EXPO|EXPO
EXPR|EXPR
EXR|EXR
EXTR|EXTR
EYE|EYE
EYEN|EYEN
EYLD|EYLD
EYPT|EYPT
EZA|EZA
EZFL|EZFL
EZGO|EZGO
EZJ|EZJ
EZM|EZM
EZPW|EZPW
EZU|EZU
F|F
F PRB|FpB
F PRC|FpC
F PRD|FpD
FA|FA
FAAR|FAAR
FAB|FAB
FACA|FACA
FACA U|FACA.U
FACA WS|FACA.WS
FACT|FACT
FACT U|FACT.U
FACT WS|FACT.WS
FAD|FAD
FAF|FAF
FAIL|FAIL
FALN|FALN
FAM|FAM
FAMI|FAMI
FAN|FAN
FANG|FANG
FANH|FANH
FAPR|FAPR
FARM|FARM
FARO|FARO
FAS|FAS
FAST|FAST
FAT|FAT
FATBB|FATBB
FATBP|FATBP
FATBW|FATBW
FATE|FATE
FATH|FATH
FATH WS|FATH.WS
FATP|FATP
FATPU|FATPU
FATPW|FATPW
FAUG|FAUG
FAX|FAX
FAZ|FAZ
FAZE|FAZE
FAZEW|FAZEW
FBCG|FBCG
FBCV|FBCV
FBGX|FBGX
FBHS|FBHS
FBIO|FBIO
FBIOP|FBIOP
FBIZ|FBIZ
FBK|FBK
FBMS|FBMS
FBNC|FBNC
FBND|FBND
FBP|FBP
FBRT|FBRT
FBRT PRE|FBRTpE
FBRX|FBRX
FBT|FBT
FBZ|FBZ
FC|FC
FCA|FCA
FCAL|FCAL
FCAP|FCAP
FCAX|FCAX
FCAX U|FCAX.U
FCAX WS|FCAX.WS
FCBC|FCBC
FCCO|FCCO
FCEF|FCEF
FCEL|FCEL
FCF|FCF
FCFS|FCFS
FCG|FCG
FCLD|FCLD
FCN|FCN
FCNCA|FCNCA
FCNCO|FCNCO
FCNCP|FCNCP
FCO|FCO
FCOM|FCOM
FCOR|FCOR
FCPI|FCPI
FCPT|FCPT
FCRD|FCRD
FCRX|FCRX
FCSH|FCSH
FCT|FCT
FCTR|FCTR
FCUV|FCUV
FCVT|FCVT
FCX|FCX
FDBC|FDBC
FDD|FDD
FDEC|FDEC
FDEM|FDEM
FDEU|FDEU
FDEV|FDEV
FDG|FDG
FDHT|FDHT
FDHY|FDHY
FDIG|FDIG
FDIS|FDIS
FDL|FDL
FDLO|FDLO
FDLS|FDLS
FDM|FDM
FDMO|FDMO
FDMT|FDMT
FDN|FDN
FDNI|FDNI
FDP|FDP
FDRR|FDRR
FDRV|FDRV
FDS|FDS
FDT|FDT
FDTS|FDTS
FDUS|FDUS
FDV|FDV
FDVV|FDVV
FDWM|FDWM
FDX|FDX
FE|FE
FEAM|FEAM
FEBZ|FEBZ
FEDL|FEDL
FEDM|FEDM
FEDU|FEDU
FEEM|FEEM
FEHY|FEHY
FEI|FEI
FEIG|FEIG
FEIM|FEIM
FELE|FELE
FEM|FEM
FEMA|FEMA
FEMB|FEMB
FEMS|FEMS
FEMY|FEMY
FEN|FEN
FENC|FENC
FENG|FENG
FENY|FENY
FEP|FEP
FERG|FERG
FET|FET
FEUS|FEUS
FEUZ|FEUZ
FEX|FEX
FEXD|FEXD
FEXDR|FEXDR
FEXDU|FEXDU
FEXDW|FEXDW
FEZ|FEZ
FF|FF
FFA|FFA
FFBC|FFBC
FFBW|FFBW
FFC|FFC
FFEB|FFEB
FFHG|FFHG
FFHL|FFHL
FFIC|FFIC
FFIE|FFIE
FFIEW|FFIEW
FFIN|FFIN
FFIU|FFIU
FFIV|FFIV
FFND|FFND
FFNW|FFNW
FFSG|FFSG
FFTG|FFTG
FFTI|FFTI
FFTY|FFTY
FFWM|FFWM
FG|FG
FGB|FGB
FGBI|FGBI
FGBIP|FGBIP
FGD|FGD
FGEN|FGEN
FGF|FGF
FGFPP|FGFPP
FGI|FGI
FGIWW|FGIWW
FGLD|FGLD
FGM|FGM
FGMC|FGMC
FGMCU|FGMCU
FGMCW|FGMCW
FGRO|FGRO
FHB|FHB
FHI|FHI
FHLC|FHLC
FHLT|FHLT
FHLTU|FHLTU
FHLTW|FHLTW
FHN|FHN
FHN PRB|FHNpB
FHN PRC|FHNpC
FHN PRD|FHNpD
FHN PRE|FHNpE
FHN PRF|FHNpF
FHTX|FHTX
FHYS|FHYS
FIAC|FIAC
FIACU|FIACU
FIACW|FIACW
FIAX|FIAX
FIBK|FIBK
FIBR|FIBR
FICO|FICO
FICS|FICS
FICV|FICV
FICVU|FICVU
FICVW|FICVW
FID|FID
FIDI|FIDI
FIDU|FIDU
FIEE|FIEE
FIF|FIF
FIG|FIG
FIGB|FIGB
FIGS|FIGS
FIHD|FIHD
FILL|FILL
FINM|FINM
FINMU|FINMU
FINMW|FINMW
FINS|FINS
FINV|FINV
FINW|FINW
FINX|FINX
FIP|FIP
FIS|FIS
FISI|FISI
FISK|FISK
FISR|FISR
FISV|FISV
FITB|FITB
FITBI|FITBI
FITBO|FITBO
FITBP|FITBP
FITE|FITE
FIVA|FIVA
FIVE|FIVE
FIVG|FIVG
FIVN|FIVN
FIVR|FIVR
FIW|FIW
FIX|FIX
FIXD|FIXD
FIXX|FIXX
FIZZ|FIZZ
FJAN|FJAN
FJP|FJP
FJUL|FJUL
FJUN|FJUN
FKU|FKU
FKWL|FKWL
FL|FL
FLAG|FLAG
FLAG U|FLAG.U
FLAG WS|FLAG.WS
FLAU|FLAU
FLAX|FLAX
FLBL|FLBL
FLBR|FLBR
FLC|FLC
FLCA|FLCA
FLCB|FLCB
FLCH|FLCH
FLCO|FLCO
FLDR|FLDR
FLDZ|FLDZ
FLEE|FLEE
FLEH|FLEH
FLEX|FLEX
FLFR|FLFR
FLFV|FLFV
FLFVR|FLFVR
FLFVU|FLFVU
FLFVW|FLFVW
FLGB|FLGB
FLGC|FLGC
FLGR|FLGR
FLGT|FLGT
FLGV|FLGV
FLHK|FLHK
FLHY|FLHY
FLIA|FLIA
FLIC|FLIC
FLIN|FLIN
FLIY|FLIY
FLJ|FLJ
FLJH|FLJH
FLJP|FLJP
FLKR|FLKR
FLL|FLL
FLLA|FLLA
FLLV|FLLV
FLMB|FLMB
FLME|FLME
FLME U|FLME.U
FLME WS|FLME.WS
FLMI|FLMI
FLMX|FLMX
FLN|FLN
FLNC|FLNC
FLNG|FLNG
FLNT|FLNT
FLO|FLO
FLOT|FLOT
FLQL|FLQL
FLQM|FLQM
FLQS|FLQS
FLR|FLR
FLRG|FLRG
FLRN|FLRN
FLRT|FLRT
FLRU|FLRU
FLS|FLS
FLSA|FLSA
FLSP|FLSP
FLSW|FLSW
FLT|FLT
FLTB|FLTB
FLTN|FLTN
FLTR|FLTR
FLTW|FLTW
FLUD|FLUD
FLUX|FLUX
FLV|FLV
FLWS|FLWS
FLXS|FLXS
FLYA|FLYA
FLYA U|FLYA.U
FLYA WS|FLYA.WS
FLYD|FLYD
FLYU|FLYU
FLYW|FLYW
FLZA|FLZA
FM|FM
FMAG|FMAG
FMAO|FMAO
FMAR|FMAR
FMAT|FMAT
FMAY|FMAY
FMB|FMB
FMBH|FMBH
FMC|FMC
FMCX|FMCX
FMET|FMET
FMF|FMF
FMHI|FMHI
FMIL|FMIL
FMIV|FMIV
FMIVU|FMIVU
FMIVW|FMIVW
FMN|FMN
FMNB|FMNB
FMNY|FMNY
FMQQ|FMQQ
FMS|FMS
FMX|FMX
FMY|FMY
FN|FN
FNA|FNA
FNB|FNB
FNB PRE|FNBpE
FNCB|FNCB
FNCH|FNCH
FNCL|FNCL
FND|FND
FNDA|FNDA
FNDB|FNDB
FNDC|FNDC
FNDE|FNDE
FNDF|FNDF
FNDX|FNDX
FNF|FNF
FNGD|FNGD
FNGG|FNGG
FNGO|FNGO
FNGR|FNGR
FNGS|FNGS
FNGU|FNGU
FNI|FNI
FNK|FNK
FNKO|FNKO
FNLC|FNLC
FNOV|FNOV
FNTC|FNTC
FNV|FNV
FNVT|FNVT
FNVTU|FNVTU
FNVTW|FNVTW
FNWB|FNWB
FNWD|FNWD
FNX|FNX
FNY|FNY
FOA|FOA
FOA WS|FOA.WS
FOCS|FOCS
FOCT|FOCT
FOF|FOF
FOLD|FOLD
FOMO|FOMO
FONR|FONR
FOR|FOR
FORA|FORA
FORD|FORD
FORG|FORG
FORH|FORH
FORM|FORM
FORR|FORR
FORTY|FORTY
FOSL|FOSL
FOSLL|FOSLL
FOUR|FOUR
FOVL|FOVL
FOX|FOX
FOXA|FOXA
FOXF|FOXF
FOXO|FOXO
FOXO WS|FOXO.WS
FOXW|FOXW
FOXWU|FOXWU
FOXWW|FOXWW
FPA|FPA
FPAC|FPAC
FPAC U|FPAC.U
FPAC WS|FPAC.WS
FPAG|FPAG
FPAY|FPAY
FPE|FPE
FPEI|FPEI
FPF|FPF
FPFD|FPFD
FPH|FPH
FPI|FPI
FPL|FPL
FPRO|FPRO
FPX|FPX
FPXE|FPXE
FPXI|FPXI
FQAL|FQAL
FR|FR
FRA|FRA
FRAF|FRAF
FRBA|FRBA
FRBK|FRBK
FRBN|FRBN
FRBNU|FRBNU
FRBNW|FRBNW
FRC|FRC
FRC PRH|FRCpH
FRC PRI|FRCpI
FRC PRJ|FRCpJ
FRC PRK|FRCpK
FRC PRL|FRCpL
FRC PRM|FRCpM
FRC PRN|FRCpN
FRD|FRD
FRDM|FRDM
FREE|FREE
FREEW|FREEW
FREL|FREL
FREQ|FREQ
FREY|FREY
FREY WS|FREY.WS
FRG|FRG
FRGAP|FRGAP
FRGE|FRGE
FRGI|FRGI
FRGT|FRGT
FRHC|FRHC
FRI|FRI
FRLA|FRLA
FRLAU|FRLAU
FRLAW|FRLAW
FRLN|FRLN
FRME|FRME
FRMEP|FRMEP
FRNW|FRNW
FRO|FRO
FROG|FROG
FRON|FRON
FRONU|FRONU
FRONW|FRONW
FRPH|FRPH
FRPT|FRPT
FRSG|FRSG
FRSGU|FRSGU
FRSGW|FRSGW
FRSH|FRSH
FRST|FRST
FRSX|FRSX
FRT|FRT
FRT PRC|FRTpC
FRTX|FRTX
FRTY|FRTY
FRXB|FRXB
FRXB U|FRXB.U
FRXB WS|FRXB.WS
FRZA|FRZA
FSBC|FSBC
FSBD|FSBD
FSBW|FSBW
FSCO|FSCO
FSD|FSD
FSEA|FSEA
FSEC|FSEC
FSEP|FSEP
FSFG|FSFG
FSI|FSI
FSIG|FSIG
FSK|FSK
FSLD|FSLD
FSLR|FSLR
FSLY|FSLY
FSM|FSM
FSMB|FSMB
FSMD|FSMD
FSMO|FSMO
FSNB|FSNB
FSNB U|FSNB.U
FSP|FSP
FSR|FSR
FSRX|FSRX
FSRXU|FSRXU
FSRXW|FSRXW
FSS|FSS
FSSI|FSSI
FSSIU|FSSIU
FSSIW|FSSIW
FSST|FSST
FSTA|FSTA
FSTR|FSTR
FSTX|FSTX
FSV|FSV
FSYD|FSYD
FSZ|FSZ
FT|FT
FTA|FTA
FTAA|FTAA
FTAAU|FTAAU
FTAAW|FTAAW
FTAG|FTAG
FTAI|FTAI
FTAIN|FTAIN
FTAIO|FTAIO
FTAIP|FTAIP
FTC|FTC
FTCH|FTCH
FTCI|FTCI
FTCS|FTCS
FTCV|FTCV
FTCVU|FTCVU
FTCVW|FTCVW
FTDR|FTDR
FTDS|FTDS
FTEC|FTEC
FTEK|FTEK
FTEV|FTEV
FTEV U|FTEV.U
FTEV WS|FTEV.WS
FTF|FTF
FTFT|FTFT
FTGC|FTGC
FTGS|FTGS
FTHI|FTHI
FTHM|FTHM
FTHY|FTHY
FTI|FTI
FTII|FTII
FTIIU|FTIIU
FTIIW|FTIIW
FTK|FTK
FTLS|FTLS
FTNT|FTNT
FTPA|FTPA
FTPAU|FTPAU
FTPAW|FTPAW
FTQI|FTQI
FTRI|FTRI
FTS|FTS
FTSD|FTSD
FTSL|FTSL
FTSM|FTSM
FTV|FTV
FTVI|FTVI
FTVIU|FTVIU
FTVIW|FTVIW
FTXG|FTXG
FTXH|FTXH
FTXL|FTXL
FTXN|FTXN
FTXO|FTXO
FTXR|FTXR
FUBO|FUBO
FUE|FUE
FUL|FUL
FULC|FULC
FULT|FULT
FULTP|FULTP
FUMB|FUMB
FUN|FUN
FUNC|FUNC
FUND|FUND
FUNL|FUNL
FURY|FURY
FUSB|FUSB
FUSN|FUSN
FUTU|FUTU
FUTY|FUTY
FUV|FUV
FV|FV
FVAL|FVAL
FVC|FVC
FVCB|FVCB
FVD|FVD
FVRR|FVRR
FWAC|FWAC
FWBI|FWBI
FWONA|FWONA
FWONK|FWONK
FWP|FWP
FWRD|FWRD
FWRG|FWRG
FXA|FXA
FXB|FXB
FXC|FXC
FXCO|FXCO
FXCOR|FXCOR
FXCOW|FXCOW
FXD|FXD
FXE|FXE
FXF|FXF
FXG|FXG
FXH|FXH
FXI|FXI
FXL|FXL
FXLV|FXLV
FXN|FXN
FXNC|FXNC
FXO|FXO
FXP|FXP
FXR|FXR
FXU|FXU
FXY|FXY
FXZ|FXZ
FYBR|FYBR
FYC|FYC
FYLD|FYLD
FYLG|FYLG
FYT|FYT
FYX|FYX
FZT|FZT
FZT U|FZT.U
FZT WS|FZT.WS
G|G
GAA|GAA
GAB|GAB
GAB PRG|GABpG
GAB PRH|GABpH
GAB PRK|GABpK
GABC|GABC
GABF|GABF
GACQ|GACQ
GACQU|GACQU
GACQW|GACQW
GAIA|GAIA
GAIN|GAIN
GAINN|GAINN
GAINZ|GAINZ
GAL|GAL
GALT|GALT
GAM|GAM
GAM PRB|GAMpB
GAMB|GAMB
GAMC|GAMC
GAMCU|GAMCU
GAMCW|GAMCW
GAME|GAME
GAMR|GAMR
GAN|GAN
GANX|GANX
GAQ|GAQ
GAQ U|GAQ.U
GAQ WS|GAQ.WS
GASS|GASS
GAST|GAST
GATE|GATE
GATEU|GATEU
GATEW|GATEW
GATO|GATO
GATX|GATX
GAU|GAU
GAZ|GAZ
GB|GB
GB WS|GB.WS
GBAB|GBAB
GBBK|GBBK
GBBKR|GBBKR
GBBKW|GBBKW
GBCI|GBCI
GBDC|GBDC
GBF|GBF
GBIL|GBIL
GBIO|GBIO
GBLD|GBLD
GBLI|GBLI
GBNH|GBNH
GBNY|GBNY
GBR|GBR
GBRG|GBRG
GBRGR|GBRGR
GBRGU|GBRGU
GBRGW|GBRGW
GBTG|GBTG
GBUG|GBUG
GBUY|GBUY
GBX|GBX
GCBC|GCBC
GCC|GCC
GCI|GCI
GCLN|GCLN
GCMG|GCMG
GCMGW|GCMGW
GCO|GCO
GCOR|GCOR
GCOW|GCOW
GCT|GCT
GCTK|GCTK
GCV|GCV
GD|GD
GDDY|GDDY
GDE|GDE
GDEN|GDEN
GDEV|GDEV
GDEVW|GDEVW
GDIV|GDIV
GDL|GDL
GDL PRC|GDLpC
GDMA|GDMA
GDMN|GDMN
GDNR|GDNR
GDNRU|GDNRU
GDNRW|GDNRW
GDO|GDO
GDOC|GDOC
GDOT|GDOT
GDRX|GDRX
GDS|GDS
GDST|GDST
GDSTR|GDSTR
GDSTU|GDSTU
GDSTW|GDSTW
GDV|GDV
GDV PRH|GDVpH
GDV PRK|GDVpK
GDVD|GDVD
GDX|GDX
GDXD|GDXD
GDXJ|GDXJ
GDXU|GDXU
GDYN|GDYN
GE|GE
GECC|GECC
GECCM|GECCM
GECCN|GECCN
GECCO|GECCO
GEEX|GEEX
GEEXU|GEEXU
GEEXW|GEEXW
GEF|GEF
GEF B|GEF.B
GEG|GEG
GEGGL|GEGGL
GEHI|GEHI
GEL|GEL
GEM|GEM
GEMD|GEMD
GEN|GEN
GENC|GENC
GENE|GENE
GENI|GENI
GENI WS|GENI.WS
GENQ|GENQ
GENQU|GENQU
GENQW|GENQW
GENY|GENY
GEO|GEO
GEOS|GEOS
GER|GER
GERM|GERM
GERN|GERN
GES|GES
GET|GET
GETY|GETY
GEVO|GEVO
GF|GF
GFAI|GFAI
GFAIW|GFAIW
GFF|GFF
GFGD|GFGD
GFGDR|GFGDR
GFGDU|GFGDU
GFGDW|GFGDW
GFGF|GFGF
GFI|GFI
GFL|GFL
GFLU|GFLU
GFOF|GFOF
GFOR|GFOR
GFOR U|GFOR.U
GFOR WS|GFOR.WS
GFS|GFS
GFX|GFX
GFX U|GFX.U
GFX WS|GFX.WS
GGAA|GGAA
GGAAU|GGAAU
GGAAW|GGAAW
GGAL|GGAL
GGB|GGB
GGE|GGE
GGG|GGG
GGLL|GGLL
GGLS|GGLS
GGMC|GGMC
GGMCU|GGMCU
GGMCW|GGMCW
GGN|GGN
GGN PRB|GGNpB
GGR|GGR
GGROW|GGROW
GGRW|GGRW
GGT|GGT
GGT PRE|GGTpE
GGT PRG|GGTpG
GGZ|GGZ
GH|GH
GHAC|GHAC
GHACU|GHACU
GHACW|GHACW
GHC|GHC
GHG|GHG
GHI|GHI
GHIX|GHIX
GHIXU|GHIXU
GHIXW|GHIXW
GHL|GHL
GHLD|GHLD
GHM|GHM
GHRS|GHRS
GHSI|GHSI
GHTA|GHTA
GHY|GHY
GHYB|GHYB
GHYG|GHYG
GIA|GIA
GIA U|GIA.U
GIA WS|GIA.WS
GIAC|GIAC
GIACU|GIACU
GIACW|GIACW
GIB|GIB
GIC|GIC
GIFI|GIFI
GIGB|GIGB
GIGM|GIGM
GII|GII
GIII|GIII
GIIX|GIIX
GIIXU|GIIXU
GIIXW|GIIXW
GIL|GIL
GILD|GILD
GILT|GILT
GIM|GIM
GINN|GINN
GIPR|GIPR
GIPRW|GIPRW
GIS|GIS
GIW|GIW
GIWWU|GIWWU
GIWWW|GIWWW
GJH|GJH
GJO|GJO
GJP|GJP
GJR|GJR
GJS|GJS
GJT|GJT
GK|GK
GKOS|GKOS
GL|GL
GL PRD|GLpD
GLAD|GLAD
GLBE|GLBE
GLBL|GLBL
GLBLU|GLBLU
GLBLW|GLBLW
GLBS|GLBS
GLBZ|GLBZ
GLCN|GLCN
GLD|GLD
GLDB|GLDB
GLDD|GLDD
GLDG|GLDG
GLDI|GLDI
GLDM|GLDM
GLDX|GLDX
GLG|GLG
GLHA|GLHA
GLHAU|GLHAU
GLHAW|GLHAW
GLIF|GLIF
GLIN|GLIN
GLL|GLL
GLLI|GLLI
GLLIR|GLLIR
GLLIU|GLLIU
GLLIW|GLLIW
GLMD|GLMD
GLNG|GLNG
GLO|GLO
GLOB|GLOB
GLOG PRA|GLOGpA
GLOP|GLOP
GLOP PRA|GLOPpA
GLOP PRB|GLOPpB
GLOP PRC|GLOPpC
GLOV|GLOV
GLP|GLP
GLP PRA|GLPpA
GLP PRB|GLPpB
GLPG|GLPG
GLPI|GLPI
GLQ|GLQ
GLRE|GLRE
GLRY|GLRY
GLS|GLS
GLS WS|GLS.WS
GLSI|GLSI
GLST|GLST
GLSTR|GLSTR
GLSTU|GLSTU
GLSTW|GLSTW
GLT|GLT
GLTA|GLTA
GLTA U|GLTA.U
GLTA WS|GLTA.WS
GLTO|GLTO
GLTR|GLTR
GLU|GLU
GLU PRA|GLUpA
GLU PRB|GLUpB
GLUE|GLUE
GLV|GLV
GLW|GLW
GLYC|GLYC
GM|GM
GMAB|GMAB
GMBL|GMBL
GMBLP|GMBLP
GMBLW|GMBLW
GMBLZ|GMBLZ
GMDA|GMDA
GME|GME
GMED|GMED
GMET|GMET
GMF|GMF
GMFI|GMFI
GMFIU|GMFIU
GMFIW|GMFIW
GMGI|GMGI
GMOM|GMOM
GMRE|GMRE
GMRE PRA|GMREpA
GMS|GMS
GMTX|GMTX
GMVD|GMVD
GMVDW|GMVDW
GNAC|GNAC
GNACU|GNACU
GNACW|GNACW
GNE|GNE
GNE PRA|GNEpA
GNFT|GNFT
GNK|GNK
GNL|GNL
GNL PRA|GNLpA
GNL PRB|GNLpB
GNLN|GNLN
GNMA|GNMA
GNOM|GNOM
GNPX|GNPX
GNR|GNR
GNRC|GNRC
GNS|GNS
GNSS|GNSS
GNT|GNT
GNT PRA|GNTpA
GNTA|GNTA
GNTX|GNTX
GNTY|GNTY
GNUS|GNUS
GNW|GNW
GO|GO
GOAU|GOAU
GOCO|GOCO
GOEV|GOEV
GOEVW|GOEVW
GOEX|GOEX
GOF|GOF
GOGL|GOGL
GOGN|GOGN
GOGN U|GOGN.U
GOGN WS|GOGN.WS
GOGO|GOGO
GOL|GOL
GOLD|GOLD
GOLF|GOLF
GOOD|GOOD
GOODN|GOODN
GOODO|GOODO
GOOG|GOOG
GOOGL|GOOGL
GOOS|GOOS
GORO|GORO
GOSS|GOSS
GOTU|GOTU
GOVT|GOVT
GOVX|GOVX
GOVXW|GOVXW
GOVZ|GOVZ
GP|GP
GPAC|GPAC
GPACU|GPACU
GPACW|GPACW
GPAL|GPAL
GPC|GPC
GPI|GPI
GPJA|GPJA
GPK|GPK
GPMT|GPMT
GPMT PRA|GPMTpA
GPN|GPN
GPOR|GPOR
GPP|GPP
GPRE|GPRE
GPRK|GPRK
GPRO|GPRO
GPS|GPS
GQRE|GQRE
GRAB|GRAB
GRABW|GRABW
GRAY|GRAY
GRBK|GRBK
GRBK PRA|GRBKpA
GRC|GRC
GRCL|GRCL
GRCY|GRCY
GRCYU|GRCYU
GRCYW|GRCYW
GREE|GREE
GREEL|GREEL
GREI|GREI
GREK|GREK
GRES|GRES
GRF|GRF
GRFS|GRFS
GRFX|GRFX
GRID|GRID
GRIL|GRIL
GRIN|GRIN
GRMN|GRMN
GRN|GRN
GRNA|GRNA
GRNAW|GRNAW
GRNB|GRNB
GRND|GRND
GRND WS|GRND.WS
GRNQ|GRNQ
GRNR|GRNR
GRNT|GRNT
GRNT WS|GRNT.WS
GROM|GROM
GROMW|GROMW
GROV|GROV
GROV WS|GROV.WS
GROW|GROW
GROY|GROY
GROY WS|GROY.WS
GRP U|GRP.U
GRPH|GRPH
GRPN|GRPN
GRRR|GRRR
GRRRW|GRRRW
GRTS|GRTS
GRTX|GRTX
GRU|GRU
GRVY|GRVY
GRWG|GRWG
GRX|GRX
GRZZ|GRZZ
GS|GS
GS PRA|GSpA
GS PRC|GSpC
GS PRD|GSpD
GS PRJ|GSpJ
GS PRK|GSpK
GSAT|GSAT
GSBC|GSBC
GSBD|GSBD
GSD|GSD
GSDWU|GSDWU
GSDWW|GSDWW
GSEE|GSEE
GSEU|GSEU
GSEV|GSEV
GSEVU|GSEVU
GSEVW|GSEVW
GSEW|GSEW
GSFP|GSFP
GSG|GSG
GSHD|GSHD
GSID|GSID
GSIE|GSIE
GSIG|GSIG
GSIT|GSIT
GSJY|GSJY
GSK|GSK
GSL|GSL
GSL PRB|GSLpB
GSLC|GSLC
GSM|GSM
GSMG|GSMG
GSMGW|GSMGW
GSP|GSP
GSPY|GSPY
GSQB|GSQB
GSQB U|GSQB.U
GSQB WS|GSQB.WS
GSQD|GSQD
GSQD U|GSQD.U
GSRM|GSRM
GSRMR|GSRMR
GSRMU|GSRMU
GSRMW|GSRMW
GSSC|GSSC
GSST|GSST
GSUN|GSUN
GSUS|GSUS
GSY|GSY
GT|GT
GTAC|GTAC
GTACU|GTACU
GTACW|GTACW
GTBP|GTBP
GTE|GTE
GTEC|GTEC
GTEK|GTEK
GTES|GTES
GTH|GTH
GTHX|GTHX
GTIM|GTIM
GTIP|GTIP
GTLB|GTLB
GTLS|GTLS
GTN|GTN
GTN A|GTN.A
GTO|GTO
GTPA|GTPA
GTPAU|GTPAU
GTPAW|GTPAW
GTPB|GTPB
GTPBU|GTPBU
GTPBW|GTPBW
GTR|GTR
GTX|GTX
GTXAP|GTXAP
GTY|GTY
GUG|GUG
GUNR|GUNR
GURE|GURE
GURU|GURU
GUSA|GUSA
GUSH|GUSH
GUT|GUT
GUT PRC|GUTpC
GVA|GVA
GVAL|GVAL
GVCI|GVCI
GVCIU|GVCIU
GVCIW|GVCIW
GVI|GVI
GVIP|GVIP
GVLU|GVLU
GVP|GVP
GWAV|GWAV
GWH|GWH
GWH WS|GWH.WS
GWII|GWII
GWIIW|GWIIW
GWRE|GWRE
GWRS|GWRS
GWW|GWW
GWX|GWX
GXC|GXC
GXG|GXG
GXII|GXII
GXIIU|GXIIU
GXIIW|GXIIW
GXO|GXO
GXTG|GXTG
GYLD|GYLD
GYRO|GYRO
H|H
HA|HA
HACK|HACK
HAE|HAE
HAFC|HAFC
HAIA|HAIA
HAIAU|HAIAU
HAIAW|HAIAW
HAIL|HAIL
HAIN|HAIN
HAL|HAL
HALL|HALL
HALO|HALO
HAP|HAP
HAPI|HAPI
HAPP|HAPP
HAPY|HAPY
HARP|HARP
HART|HART
HAS|HAS
HASI|HASI
HAUS|HAUS
HAUZ|HAUZ
HAWX|HAWX
HAYN|HAYN
HAYW|HAYW
HBAN|HBAN
HBANM|HBANM
HBANP|HBANP
HBB|HBB
HBCP|HBCP
HBI|HBI
HBIO|HBIO
HBM|HBM
HBNC|HBNC
HBT|HBT
HCA|HCA
HCAR|HCAR
HCARU|HCARU
HCARW|HCARW
HCAT|HCAT
HCC|HCC
HCCI|HCCI
HCDI|HCDI
HCDIP|HCDIP
HCDIW|HCDIW
HCDIZ|HCDIZ
HCI|HCI
HCIC|HCIC
HCICU|HCICU
HCICW|HCICW
HCII|HCII
HCIIU|HCIIU
HCIIW|HCIIW
HCKT|HCKT
HCM|HCM
HCMA|HCMA
HCMAU|HCMAU
HCMAW|HCMAW
HCNE|HCNE
HCNEU|HCNEU
HCNEW|HCNEW
HCOM|HCOM
HCP|HCP
HCRB|HCRB
HCSG|HCSG
HCTI|HCTI
HCVI|HCVI
HCVIU|HCVIU
HCVIW|HCVIW
HCWB|HCWB
HCXY|HCXY
HD|HD
HDAW|HDAW
HDB|HDB
HDEF|HDEF
HDG|HDG
HDGE|HDGE
HDIV|HDIV
HDLB|HDLB
HDMV|HDMV
HDRO|HDRO
HDSN|HDSN
HDUS|HDUS
HDV|HDV
HE|HE
HEAR|HEAR
HEDJ|HEDJ
HEEM|HEEM
HEES|HEES
HEET|HEET
HEFA|HEFA
HEGD|HEGD
HEI|HEI
HEI A|HEI.A
HELE|HELE
HELX|HELX
HEP|HEP
HEPA|HEPA
HEPS|HEPS
HEQ|HEQ
HEQT|HEQT
HERA|HERA
HERAU|HERAU
HERAW|HERAW
HERD|HERD
HERO|HERO
HES|HES
HESM|HESM
HEWC|HEWC
HEWG|HEWG
HEWJ|HEWJ
HEWU|HEWU
HEXO|HEXO
HEZU|HEZU
HFBL|HFBL
HFFG|HFFG
HFGO|HFGO
HFND|HFND
HFRO|HFRO
HFRO PRA|HFROpA
HFWA|HFWA
HFXI|HFXI
HGBL|HGBL
HGEN|HGEN
HGER|HGER
HGLB|HGLB
HGTY|HGTY
HGTY WS|HGTY.WS
HGV|HGV
HHC|HHC
HHGC|HHGC
HHGCR|HHGCR
HHGCU|HHGCU
HHGCW|HHGCW
HHLA|HHLA
HHLA U|HHLA.U
HHLA WS|HHLA.WS
HHR|HHR
HHS|HHS
HI|HI
HIBB|HIBB
HIBL|HIBL
HIBS|HIBS
HIDE|HIDE
HIE|HIE
HIFS|HIFS
HIG|HIG
HIG PRG|HIGpG
HIGH|HIGH
HIHO|HIHO
HII|HII
HIII|HIII
HIIIU|HIIIU
HIIIW|HIIIW
HIL|HIL
HILS|HILS
HIMS|HIMS
HIMX|HIMX
HIO|HIO
HIPO|HIPO
HIPO WS|HIPO.WS
HIPS|HIPS
HISF|HISF
HITI|HITI
HIVE|HIVE
HIW|HIW
HIX|HIX
HJEN|HJEN
HKD|HKD
HKND|HKND
HL|HL
HL PRB|HLpB
HLAH|HLAH
HLAHU|HLAHU
HLAHW|HLAHW
HLAL|HLAL
HLBZ|HLBZ
HLBZW|HLBZW
HLF|HLF
HLGE|HLGE
HLGN|HLGN
HLGN WS|HLGN.WS
HLI|HLI
HLIO|HLIO
HLIT|HLIT
HLLY|HLLY
HLLY WS|HLLY.WS
HLMN|HLMN
HLN|HLN
HLNE|HLNE
HLT|HLT
HLTH|HLTH
HLVX|HLVX
HLX|HLX
HMA|HMA
HMA U|HMA.U
HMA WS|HMA.WS
HMAC|HMAC
HMACR|HMACR
HMACU|HMACU
HMACW|HMACW
HMC|HMC
HMLP PRA|HMLPpA
HMN|HMN
HMNF|HMNF
HMOP|HMOP
HMPT|HMPT
HMST|HMST
HMY|HMY
HNDL|HNDL
HNI|HNI
HNNA|HNNA
HNNAZ|HNNAZ
HNRA|HNRA
HNRA WS|HNRA.WS
HNRG|HNRG
HNST|HNST
HNVR|HNVR
HNW|HNW
HOFT|HOFT
HOFV|HOFV
HOFVW|HOFVW
HOG|HOG
HOLD|HOLD
HOLI|HOLI
HOLO|HOLO
HOLOW|HOLOW
HOLX|HOLX
HOM|HOM
HOMB|HOMB
HOMZ|HOMZ
HON|HON
HONE|HONE
HOOD|HOOD
HOOK|HOOK
HOPE|HOPE
HORI|HORI
HORIU|HORIU
HORIW|HORIW
HOTH|HOTH
HOTL|HOTL
HOUR|HOUR
HOUS|HOUS
HOV|HOV
HOVNP|HOVNP
HOWL|HOWL
HP|HP
HPCO|HPCO
HPE|HPE
HPF|HPF
HPI|HPI
HPK|HPK
HPKEW|HPKEW
HPLT|HPLT
HPLTU|HPLTU
HPLTW|HPLTW
HPP|HPP
HPP PRC|HPPpC
HPQ|HPQ
HPS|HPS
HPX|HPX
HPX U|HPX.U
HPX WS|HPX.WS
HQH|HQH
HQI|HQI
HQL|HQL
HQY|HQY
HR|HR
HRB|HRB
HRI|HRI
HRL|HRL
HRMY|HRMY
HROW|HROW
HROWL|HROWL
HRT|HRT
HRTG|HRTG
HRTX|HRTX
HRZN|HRZN
HSAQ|HSAQ
HSBC|HSBC
HSC|HSC
HSCS|HSCS
HSCSW|HSCSW
HSCZ|HSCZ
HSDT|HSDT
HSIC|HSIC
HSII|HSII
HSKA|HSKA
HSMV|HSMV
HSON|HSON
HSRT|HSRT
HST|HST
HSTM|HSTM
HSTO|HSTO
HSUN|HSUN
HSY|HSY
HT|HT
HT PRC|HTpC
HT PRD|HTpD
HT PRE|HTpE
HTAB|HTAB
HTBI|HTBI
HTBK|HTBK
HTCR|HTCR
HTD|HTD
HTEC|HTEC
HTFB|HTFB
HTFC|HTFC
HTGC|HTGC
HTGM|HTGM
HTH|HTH
HTHT|HTHT
HTIA|HTIA
HTIBP|HTIBP
HTLD|HTLD
HTLF|HTLF
HTLFP|HTLFP
HTOO|HTOO
HTOOW|HTOOW
HTPA|HTPA
HTPA U|HTPA.U
HTRB|HTRB
HTUS|HTUS
HTY|HTY
HTZ|HTZ
HTZWW|HTZWW
HUBB|HUBB
HUBG|HUBG
HUBS|HUBS
HUDAU|HUDAU
HUDI|HUDI
HUGE|HUGE
HUGS|HUGS
HUGS U|HUGS.U
HUIZ|HUIZ
HUM|HUM
HUMA|HUMA
HUMAW|HUMAW
HUN|HUN
HURC|HURC
HURN|HURN
HUSA|HUSA
HUSV|HUSV
HUT|HUT
HUYA|HUYA
HVAL|HVAL
HVBC|HVBC
HVT|HVT
HVT A|HVT.A
HWBK|HWBK
HWC|HWC
HWCPZ|HWCPZ
HWEL|HWEL
HWELU|HWELU
HWELW|HWELW
HWKN|HWKN
HWKZ|HWKZ
HWKZ U|HWKZ.U
HWM|HWM
HWM PR|HWMp
HXL|HXL
HY|HY
HYB|HYB
HYBB|HYBB
HYBL|HYBL
HYD|HYD
HYDB|HYDB
HYDR|HYDR
HYDW|HYDW
HYEM|HYEM
HYFM|HYFM
HYG|HYG
HYGH|HYGH
HYGI|HYGI
HYGV|HYGV
HYGW|HYGW
HYHG|HYHG
HYI|HYI
HYIN|HYIN
HYLB|HYLB
HYLD|HYLD
HYLG|HYLG
HYLN|HYLN
HYLS|HYLS
HYLV|HYLV
HYMB|HYMB
HYMC|HYMC
HYMCL|HYMCL
HYMCW|HYMCW
HYMU|HYMU
HYPR|HYPR
HYRE|HYRE
HYRM|HYRM
HYS|HYS
HYT|HYT
HYTR|HYTR
HYUP|HYUP
HYW|HYW
HYXF|HYXF
HYXU|HYXU
HYZD|HYZD
HYZN|HYZN
HYZNW|HYZNW
HZN|HZN
HZNP|HZNP
HZO|HZO
HZON|HZON
HZON U|HZON.U
HZON WS|HZON.WS
IAA|IAA
IAC|IAC
IAE|IAE
IAF|IAF
IAG|IAG
IAGG|IAGG
IAI|IAI
IAK|IAK
IAPR|IAPR
IART|IART
IAS|IAS
IAT|IAT
IAU|IAU
IAUF|IAUF
IAUM|IAUM
IAUX|IAUX
IBA|IBA
IBB|IBB
IBBQ|IBBQ
IBCE|IBCE
IBCP|IBCP
IBD|IBD
IBDD|IBDD
IBDN|IBDN
IBDO|IBDO
IBDP|IBDP
IBDQ|IBDQ
IBDR|IBDR
IBDS|IBDS
IBDT|IBDT
IBDU|IBDU
IBDV|IBDV
IBDW|IBDW
IBDX|IBDX
IBER|IBER
IBER U|IBER.U
IBER WS|IBER.WS
IBET|IBET
IBEX|IBEX
IBHB|IBHB
IBHC|IBHC
IBHD|IBHD
IBHE|IBHE
IBHF|IBHF
IBHG|IBHG
IBHH|IBHH
IBHI|IBHI
IBIO|IBIO
IBIT|IBIT
IBKR|IBKR
IBLC|IBLC
IBM|IBM
IBML|IBML
IBMM|IBMM
IBMN|IBMN
IBMO|IBMO
IBMP|IBMP
IBMQ|IBMQ
IBN|IBN
IBND|IBND
IBO|IBO
IBOC|IBOC
IBP|IBP
IBRN|IBRN
IBRX|IBRX
IBTB|IBTB
IBTD|IBTD
IBTE|IBTE
IBTF|IBTF
IBTG|IBTG
IBTH|IBTH
IBTI|IBTI
IBTJ|IBTJ
IBTK|IBTK
IBTL|IBTL
IBTM|IBTM
IBTX|IBTX
IBUY|IBUY
ICAD|ICAD
ICAP|ICAP
ICCC|ICCC
ICCH|ICCH
ICCM|ICCM
ICD|ICD
ICE|ICE
ICF|ICF
ICFI|ICFI
ICHR|ICHR
ICL|ICL
ICLK|ICLK
ICLN|ICLN
ICLR|ICLR
ICMB|ICMB
ICNC|ICNC
ICNC U|ICNC.U
ICNC WS|ICNC.WS
ICOW|ICOW
ICPT|ICPT
ICR PRA|ICRpA
ICSH|ICSH
ICU|ICU
ICUCW|ICUCW
ICUI|ICUI
ICVT|ICVT
ICVX|ICVX
ID|ID
IDA|IDA
IDAI|IDAI
IDAT|IDAT
IDBA|IDBA
IDCC|IDCC
IDE|IDE
IDEV|IDEV
IDEX|IDEX
IDHD|IDHD
IDHQ|IDHQ
IDIV|IDIV
IDLB|IDLB
IDLV|IDLV
IDME|IDME
IDMO|IDMO
IDN|IDN
IDNA|IDNA
IDOG|IDOG
IDR|IDR
IDRA|IDRA
IDRV|IDRV
IDT|IDT
IDU|IDU
IDV|IDV
IDVO|IDVO
IDW|IDW
IDX|IDX
IDXX|IDXX
IDYA|IDYA
IE|IE
IEDI|IEDI
IEF|IEF
IEFA|IEFA
IEI|IEI
IEMG|IEMG
IEO|IEO
IEP|IEP
IESC|IESC
IETC|IETC
IEUR|IEUR
IEUS|IEUS
IEV|IEV
IEX|IEX
IEZ|IEZ
IFBD|IFBD
IFED|IFED
IFF|IFF
IFGL|IFGL
IFIN|IFIN
IFIN U|IFIN.U
IFIN WS|IFIN.WS
IFN|IFN
IFRA|IFRA
IFRX|IFRX
IFS|IFS
IFV|IFV
IG|IG
IGA|IGA
IGAC|IGAC
IGACU|IGACU
IGACW|IGACW
IGBH|IGBH
IGC|IGC
IGD|IGD
IGE|IGE
IGEB|IGEB
IGF|IGF
IGHG|IGHG
IGI|IGI
IGIB|IGIB
IGIC|IGIC
IGICW|IGICW
IGLB|IGLB
IGLD|IGLD
IGM|IGM
IGMS|IGMS
IGN|IGN
IGOV|IGOV
IGR|IGR
IGRO|IGRO
IGSB|IGSB
IGT|IGT
IGTA|IGTA
IGTAR|IGTAR
IGTAU|IGTAU
IGTAW|IGTAW
IGTR|IGTR
IGV|IGV
IGZ|IGZ
IH|IH
IHAK|IHAK
IHD|IHD
IHDG|IHDG
IHE|IHE
IHF|IHF
IHG|IHG
IHI|IHI
IHIT|IHIT
IHRT|IHRT
IHS|IHS
IHT|IHT
IHTA|IHTA
IHY|IHY
IHYF|IHYF
IIF|IIF
IIGD|IIGD
IIGV|IIGV
III|III
IIII|IIII
IIIIU|IIIIU
IIIIW|IIIIW
IIIN|IIIN
IIIV|IIIV
IIM|IIM
IINN|IINN
IINNW|IINNW
IIPR|IIPR
IIPR PRA|IIPRpA
IIVIP|IIVIP
IJAN|IJAN
IJH|IJH
IJJ|IJJ
IJK|IJK
IJR|IJR
IJS|IJS
IJT|IJT
IJUL|IJUL
IKNA|IKNA
IKT|IKT
ILAG|ILAG
ILCB|ILCB
ILCG|ILCG
ILCV|ILCV
ILDR|ILDR
ILF|ILF
ILMN|ILMN
ILPT|ILPT
ILTB|ILTB
IMAB|IMAB
IMACW|IMACW
IMAQ|IMAQ
IMAQR|IMAQR
IMAQU|IMAQU
IMAQW|IMAQW
IMAX|IMAX
IMBI|IMBI
IMBIL|IMBIL
IMCB|IMCB
IMCC|IMCC
IMCG|IMCG
IMCR|IMCR
IMCV|IMCV
IMFL|IMFL
IMGN|IMGN
IMGO|IMGO
IMH|IMH
IMKTA|IMKTA
IMLP|IMLP
IMMP|IMMP
IMMR|IMMR
IMMX|IMMX
IMNM|IMNM
IMNN|IMNN
IMO|IMO
IMOM|IMOM
IMOS|IMOS
IMPL|IMPL
IMPP|IMPP
IMPPP|IMPPP
IMRA|IMRA
IMRN|IMRN
IMRX|IMRX
IMTB|IMTB
IMTE|IMTE
IMTM|IMTM
IMTX|IMTX
IMTXW|IMTXW
IMUX|IMUX
IMV|IMV
IMVT|IMVT
IMXI|IMXI
INAB|INAB
INAQ|INAQ
INAQ U|INAQ.U
INAQ WS|INAQ.WS
INBK|INBK
INBKZ|INBKZ
INBS|INBS
INBX|INBX
INC|INC
INCO|INCO
INCR|INCR
INCY|INCY
INDA|INDA
INDB|INDB
INDF|INDF
INDI|INDI
INDIW|INDIW
INDL|INDL
INDO|INDO
INDP|INDP
INDS|INDS
INDT|INDT
INDY|INDY
INFA|INFA
INFI|INFI
INFL|INFL
INFN|INFN
INFU|INFU
INFY|INFY
ING|ING
INGN|INGN
INGR|INGR
INKA|INKA
INKAU|INKAU
INKAW|INKAW
INKM|INKM
INKT|INKT
INLX|INLX
INM|INM
INMB|INMB
INMD|INMD
INMU|INMU
INN|INN
INN PRE|INNpE
INN PRF|INNpF
INNO|INNO
INNV|INNV
INO|INO
INOD|INOD
INPX|INPX
INQQ|INQQ
INSE|INSE
INSG|INSG
INSI|INSI
INSM|INSM
INSP|INSP
INST|INST
INSW|INSW
INT|INT
INTA|INTA
INTC|INTC
INTE|INTE
INTEU|INTEU
INTEW|INTEW
INTF|INTF
INTG|INTG
INTL|INTL
INTR|INTR
INTT|INTT
INTU|INTU
INTZ|INTZ
INUV|INUV
INVA|INVA
INVE|INVE
INVH|INVH
INVO|INVO
INVZ|INVZ
INVZW|INVZW
INZY|INZY
IOAC|IOAC
IOACU|IOACU
IOACW|IOACW
IOBT|IOBT
IOCT|IOCT
ION|ION
IONM|IONM
IONQ|IONQ
IONQ WS|IONQ.WS
IONR|IONR
IONS|IONS
IOO|IOO
IOR|IOR
IOSP|IOSP
IOT|IOT
IOVA|IOVA
IP|IP
IPA|IPA
IPAC|IPAC
IPAR|IPAR
IPAX|IPAX
IPAXU|IPAXU
IPAXW|IPAXW
IPAY|IPAY
IPB|IPB
IPDN|IPDN
IPDP|IPDP
IPG|IPG
IPGP|IPGP
IPHA|IPHA
IPI|IPI
IPKW|IPKW
IPO|IPO
IPOS|IPOS
IPPP|IPPP
IPSC|IPSC
IPVA|IPVA
IPVA U|IPVA.U
IPVA WS|IPVA.WS
IPVF|IPVF
IPVF U|IPVF.U
IPVF WS|IPVF.WS
IPVI|IPVI
IPVIU|IPVIU
IPVIW|IPVIW
IPW|IPW
IPWR|IPWR
IPX|IPX
IQ|IQ
IQDE|IQDE
IQDF|IQDF
IQDG|IQDG
IQDY|IQDY
IQHI|IQHI
IQI|IQI
IQIN|IQIN
IQLT|IQLT
IQM|IQM
IQMD|IQMD
IQMDU|IQMDU
IQMDW|IQMDW
IQSI|IQSI
IQSM|IQSM
IQSU|IQSU
IQV|IQV
IR|IR
IRAA|IRAA
IRAAU|IRAAU
IRAAW|IRAAW
IRBA|IRBA
IRBO|IRBO
IRBT|IRBT
IRDM|IRDM
IREN|IREN
IRIX|IRIX
IRL|IRL
IRM|IRM
IRMD|IRMD
IRNT|IRNT
IRNT WS|IRNT.WS
IROQ|IROQ
IRRX|IRRX
IRRX U|IRRX.U
IRRX WS|IRRX.WS
IRS|IRS
IRS WS|IRS.WS
IRT|IRT
IRTC|IRTC
IRVH|IRVH
IRWD|IRWD
ISAA|ISAA
ISCB|ISCB
ISCF|ISCF
ISCG|ISCG
ISCV|ISCV
ISD|ISD
ISDR|ISDR
ISDX|ISDX
ISEE|ISEE
ISEM|ISEM
ISHG|ISHG
ISHP|ISHP
ISIG|ISIG
ISMD|ISMD
ISO|ISO
ISPC|ISPC
ISPO|ISPO
ISPOW|ISPOW
ISR|ISR
ISRA|ISRA
ISRG|ISRG
ISSC|ISSC
ISTB|ISTB
ISTR|ISTR
ISUN|ISUN
ISVL|ISVL
ISWN|ISWN
ISZE|ISZE
IT|IT
ITA|ITA
ITAN|ITAN
ITAQ|ITAQ
ITAQU|ITAQU
ITAQW|ITAQW
ITB|ITB
ITCB|ITCB
ITCI|ITCI
ITEQ|ITEQ
ITGR|ITGR
ITI|ITI
ITIC|ITIC
ITM|ITM
ITOS|ITOS
ITOT|ITOT
ITP|ITP
ITQ|ITQ
ITQRU|ITQRU
ITQRW|ITQRW
ITRG|ITRG
ITRI|ITRI
ITRM|ITRM
ITRN|ITRN
ITT|ITT
ITUB|ITUB
ITW|ITW
IUS|IUS
IUSA|IUSA
IUSB|IUSB
IUSG|IUSG
IUSS|IUSS
IUSV|IUSV
IVA|IVA
IVAC|IVAC
IVAL|IVAL
IVC|IVC
IVCA|IVCA
IVCAU|IVCAU
IVCAW|IVCAW
IVCB|IVCB
IVCBU|IVCBU
IVCBW|IVCBW
IVCP|IVCP
IVCPU|IVCPU
IVCPW|IVCPW
IVDA|IVDA
IVDAW|IVDAW
IVDG|IVDG
IVE|IVE
IVEG|IVEG
IVES|IVES
IVH|IVH
IVLC|IVLC
IVLU|IVLU
IVOG|IVOG
IVOL|IVOL
IVOO|IVOO
IVOV|IVOV
IVR|IVR
IVR PRB|IVRpB
IVR PRC|IVRpC
IVRA|IVRA
IVSG|IVSG
IVT|IVT
IVV|IVV
IVVD|IVVD
IVW|IVW
IVZ|IVZ
IWB|IWB
IWC|IWC
IWD|IWD
IWDL|IWDL
IWF|IWF
IWFG|IWFG
IWFH|IWFH
IWFL|IWFL
IWIN|IWIN
IWL|IWL
IWLG|IWLG
IWM|IWM
IWML|IWML
IWN|IWN
IWO|IWO
IWP|IWP
IWR|IWR
IWS|IWS
IWTR|IWTR
IWV|IWV
IWX|IWX
IWY|IWY
IX|IX
IXAQ|IXAQ
IXAQU|IXAQU
IXAQW|IXAQW
IXC|IXC
IXG|IXG
IXHL|IXHL
IXJ|IXJ
IXN|IXN
IXP|IXP
IXSE|IXSE
IXUS|IXUS
IYC|IYC
IYE|IYE
IYF|IYF
IYG|IYG
IYH|IYH
IYJ|IYJ
IYK|IYK
IYLD|IYLD
IYM|IYM
IYR|IYR
IYT|IYT
IYW|IYW
IYY|IYY
IYZ|IYZ
IZEA|IZEA
IZRL|IZRL
J|J
JAAA|JAAA
JACK|JACK
JAGG|JAGG
JAGX|JAGX
JAKK|JAKK
JAMF|JAMF
JAN|JAN
JANT|JANT
JANW|JANW
JANX|JANX
JANZ|JANZ
JAQC|JAQC
JAQCU|JAQCU
JAQCW|JAQCW
JATT|JATT
JATT U|JATT.U
JATT WS|JATT.WS
JAVA|JAVA
JAZZ|JAZZ
JBBB|JBBB
JBGS|JBGS
JBHT|JBHT
JBI|JBI
JBK|JBK
JBL|JBL
JBLU|JBLU
JBSS|JBSS
JBT|JBT
JCE|JCE
JCI|JCI
JCIC|JCIC
JCICU|JCICU
JCICW|JCICW
JCPB|JCPB
JCPI|JCPI
JCSE|JCSE
JCTCF|JCTCF
JCTR|JCTR
JD|JD
JDST|JDST
JEF|JEF
JELD|JELD
JEMA|JEMA
JEPI|JEPI
JEPQ|JEPQ
JEQ|JEQ
JETS|JETS
JFBR|JFBR
JFBRW|JFBRW
JFIN|JFIN
JFR|JFR
JFU|JFU
JFWD|JFWD
JG|JG
JGGC|JGGC
JGGCR|JGGCR
JGGCU|JGGCU
JGGCW|JGGCW
JGH|JGH
JGRO|JGRO
JHAA|JHAA
JHCB|JHCB
JHDV|JHDV
JHEM|JHEM
JHG|JHG
JHI|JHI
JHMB|JHMB
JHMD|JHMD
JHML|JHML
JHMM|JHMM
JHPI|JHPI
JHS|JHS
JHSC|JHSC
JHX|JHX
JIB|JIB
JIDA|JIDA
JIG|JIG
JIGB|JIGB
JILL|JILL
JIRE|JIRE
JJA|JJA
JJC|JJC
JJE|JJE
JJG|JJG
JJM|JJM
JJN|JJN
JJP|JJP
JJS|JJS
JJSF|JJSF
JJT|JJT
JJU|JJU
JKHY|JKHY
JKS|JKS
JLL|JLL
JLS|JLS
JMAC|JMAC
JMACU|JMACU
JMACW|JMACW
JMBS|JMBS
JMEE|JMEE
JMIA|JMIA
JMM|JMM
JMOM|JMOM
JMSB|JMSB
JMST|JMST
JMUB|JMUB
JNCE|JNCE
JNJ|JNJ
JNK|JNK
JNPR|JNPR
JNUG|JNUG
JO|JO
JOAN|JOAN
JOB|JOB
JOBY|JOBY
JOBY WS|JOBY.WS
JOE|JOE
JOET|JOET
JOF|JOF
JOFF|JOFF
JOFFU|JOFFU
JOFFW|JOFFW
JOJO|JOJO
JOUT|JOUT
JPC|JPC
JPEM|JPEM
JPHY|JPHY
JPI|JPI
JPIB|JPIB
JPIE|JPIE
JPIN|JPIN
JPM|JPM
JPM PRC|JPMpC
JPM PRD|JPMpD
JPM PRJ|JPMpJ
JPM PRK|JPMpK
JPM PRL|JPMpL
JPM PRM|JPMpM
JPMB|JPMB
JPME|JPME
JPRE|JPRE
JPS|JPS
JPSE|JPSE
JPST|JPST
JPT|JPT
JPUS|JPUS
JPXN|JPXN
JQC|JQC
JQUA|JQUA
JRE|JRE
JRI|JRI
JRNY|JRNY
JRO|JRO
JRS|JRS
JRSH|JRSH
JRVR|JRVR
JSCP|JSCP
JSD|JSD
JSM|JSM
JSMD|JSMD
JSML|JSML
JSPR|JSPR
JSPRW|JSPRW
JSTC|JSTC
JT|JT
JUCY|JUCY
JUGG|JUGG
JUGGU|JUGGU
JUGGW|JUGGW
JULT|JULT
JULW|JULW
JULZ|JULZ
JUN|JUN
JUN U|JUN.U
JUN WS|JUN.WS
JUNZ|JUNZ
JUPW|JUPW
JUPWW|JUPWW
JUSA|JUSA
JUST|JUST
JVA|JVA
JVAL|JVAL
JWAC|JWAC
JWACR|JWACR
JWEL|JWEL
JWN|JWN
JWSM|JWSM
JWSM U|JWSM.U
JWSM WS|JWSM.WS
JXI|JXI
JXJT|JXJT
JXN|JXN
JYNT|JYNT
JZ|JZ
JZRO|JZRO
JZXN|JZXN
K|K
KACL|KACL
KACLR|KACLR
KACLU|KACLU
KACLW|KACLW
KAHC|KAHC
KAHC U|KAHC.U
KAHC WS|KAHC.WS
KAI|KAI
KAII|KAII
KAIIU|KAIIU
KAIIW|KAIIW
KAIR|KAIR
KAIRU|KAIRU
KAIRW|KAIRW
KAL|KAL
KALA|KALA
KALL|KALL
KALU|KALU
KALV|KALV
KALWW|KALWW
KAMN|KAMN
KAPR|KAPR
KAR|KAR
KARB|KARB
KARO|KARO
KARS|KARS
KAVL|KAVL
KB|KB
KBA|KBA
KBAL|KBAL
KBE|KBE
KBH|KBH
KBND|KBND
KBNT|KBNT
KBNTW|KBNTW
KBR|KBR
KBUY|KBUY
KBWB|KBWB
KBWD|KBWD
KBWP|KBWP
KBWR|KBWR
KBWY|KBWY
KC|KC
KCCA|KCCA
KCE|KCE
KCGI|KCGI
KCGI U|KCGI.U
KCGI WS|KCGI.WS
KD|KD
KDIV|KDIV
KDNY|KDNY
KDP|KDP
KDRN|KDRN
KE|KE
KEJI|KEJI
KELYA|KELYA
KELYB|KELYB
KEMQ|KEMQ
KEMX|KEMX
KEN|KEN
KEP|KEP
KEQU|KEQU
KERN|KERN
KERNW|KERNW
KESG|KESG
KEUA|KEUA
KEX|KEX
KEY|KEY
KEY PRI|KEYpI
KEY PRJ|KEYpJ
KEY PRK|KEYpK
KEY PRL|KEYpL
KEYS|KEYS
KF|KF
KFFB|KFFB
KFRC|KFRC
KFS|KFS
KFVG|KFVG
KFY|KFY
KFYP|KFYP
KGC|KGC
KGHG|KGHG
KGRN|KGRN
KGRO|KGRO
KHC|KHC
KHYB|KHYB
KIDS|KIDS
KIE|KIE
KIM|KIM
KIM PRL|KIMpL
KIM PRM|KIMpM
KIND|KIND
KINS|KINS
KINZ|KINZ
KINZU|KINZU
KINZW|KINZW
KIO|KIO
KIQ|KIQ
KIRK|KIRK
KITT|KITT
KITTW|KITTW
KJAN|KJAN
KJUL|KJUL
KKR|KKR
KKR PRC|KKRpC
KKRS|KKRS
KLAC|KLAC
KLAQ|KLAQ
KLAQU|KLAQU
KLAQW|KLAQW
KLCD|KLCD
KLDW|KLDW
KLIC|KLIC
KLNE|KLNE
KLR|KLR
KLR WS|KLR.WS
KLTR|KLTR
KLXE|KLXE
KMB|KMB
KMDA|KMDA
KMED|KMED
KMET|KMET
KMF|KMF
KMI|KMI
KMLM|KMLM
KMPB|KMPB
KMPH|KMPH
KMPR|KMPR
KMT|KMT
KMX|KMX
KN|KN
KNBE|KNBE
KNDI|KNDI
KNG|KNG
KNGS|KNGS
KNOP|KNOP
KNSA|KNSA
KNSL|KNSL
KNSW|KNSW
KNSW U|KNSW.U
KNSW WS|KNSW.WS
KNTE|KNTE
KNTK|KNTK
KNW|KNW
KNX|KNX
KO|KO
KOCG|KOCG
KOCT|KOCT
KOD|KOD
KODK|KODK
KOF|KOF
KOIN|KOIN
KOKU|KOKU
KOLD|KOLD
KOMP|KOMP
KONG|KONG
KOP|KOP
KOPN|KOPN
KORE|KORE
KORE WS|KORE.WS
KORP|KORP
KORU|KORU
KOS|KOS
KOSS|KOSS
KPLT|KPLT
KPLTW|KPLTW
KPOP|KPOP
KPRX|KPRX
KPTI|KPTI
KR|KR
KRBN|KRBN
KRBP|KRBP
KRC|KRC
KRE|KRE
KREF|KREF
KREF PRA|KREFpA
KRG|KRG
KRKR|KRKR
KRMA|KRMA
KRMD|KRMD
KRNL|KRNL
KRNLU|KRNLU
KRNLW|KRNLW
KRNT|KRNT
KRNY|KRNY
KRO|KRO
KRON|KRON
KROP|KROP
KROS|KROS
KRP|KRP
KRT|KRT
KRTX|KRTX
KRUS|KRUS
KRYS|KRYS
KSA|KSA
KSCD|KSCD
KSCP|KSCP
KSET|KSET
KSI|KSI
KSICU|KSICU
KSICW|KSICW
KSM|KSM
KSPN|KSPN
KSS|KSS
KSTR|KSTR
KT|KT
KTB|KTB
KTCC|KTCC
KTEC|KTEC
KTF|KTF
KTH|KTH
KTN|KTN
KTOS|KTOS
KTRA|KTRA
KTTA|KTTA
KTTAW|KTTAW
KUKE|KUKE
KULR|KULR
KURA|KURA
KURE|KURE
KVHI|KVHI
KVLE|KVLE
KVSA|KVSA
KVSC|KVSC
KW|KW
KWEB|KWEB
KWR|KWR
KWT|KWT
KXI|KXI
KXIN|KXIN
KYCH|KYCH
KYCHR|KYCHR
KYCHU|KYCHU
KYCHW|KYCHW
KYMR|KYMR
KYN|KYN
KZIA|KZIA
KZR|KZR
L|L
LAAA|LAAA
LAAAU|LAAAU
LAAAW|LAAAW
LAB|LAB
LABD|LABD
LABP|LABP
LABU|LABU
LAC|LAC
LAD|LAD
LADR|LADR
LAKE|LAKE
LAMR|LAMR
LANC|LANC
LAND|LAND
LANDM|LANDM
LANDO|LANDO
LARK|LARK
LASE|LASE
LASR|LASR
LATG|LATG
LATGU|LATGU
LATGW|LATGW
LAUR|LAUR
LAW|LAW
LAZ|LAZ
LAZR|LAZR
LAZY|LAZY
LBAI|LBAI
LBAY|LBAY
LBBB|LBBB
LBBBR|LBBBR
LBBBU|LBBBU
LBBBW|LBBBW
LBC|LBC
LBPH|LBPH
LBRDA|LBRDA
LBRDK|LBRDK
LBRDP|LBRDP
LBRT|LBRT
LBTYA|LBTYA
LBTYB|LBTYB
LBTYK|LBTYK
LC|LC
LCA|LCA
LCAA|LCAA
LCAAU|LCAAU
LCAAW|LCAAW
LCAHU|LCAHU
LCAHW|LCAHW
LCF|LCF
LCFY|LCFY
LCFYW|LCFYW
LCG|LCG
LCI|LCI
LCID|LCID
LCII|LCII
LCLG|LCLG
LCNB|LCNB
LCR|LCR
LCTD|LCTD
LCTU|LCTU
LCTX|LCTX
LCUT|LCUT
LCW|LCW
LCW U|LCW.U
LCW WS|LCW.WS
LD|LD
LDEM|LDEM
LDHA|LDHA
LDHAU|LDHAU
LDHAW|LDHAW
LDI|LDI
LDOS|LDOS
LDP|LDP
LDSF|LDSF
LDUR|LDUR
LE|LE
LEA|LEA
LEAD|LEAD
LECO|LECO
LEDS|LEDS
LEE|LEE
LEG|LEG
LEGA|LEGA
LEGAU|LEGAU
LEGAW|LEGAW
LEGH|LEGH
LEGN|LEGN
LEGR|LEGR
LEJU|LEJU
LEMB|LEMB
LEN|LEN
LEN B|LEN.B
LEO|LEO
LESL|LESL
LETB|LETB
LEU|LEU
LEV|LEV
LEV WS|LEV.WS
LEVI|LEVI
LEXI|LEXI
LEXX|LEXX
LEXXW|LEXXW
LFAC|LFAC
LFACU|LFACU
LFACW|LFACW
LFCR|LFCR
LFEQ|LFEQ
LFG|LFG
LFLY|LFLY
LFLYW|LFLYW
LFMD|LFMD
LFMDP|LFMDP
LFST|LFST
LFT|LFT
LFT PRA|LFTpA
LFUS|LFUS
LFVN|LFVN
LGAC|LGAC
LGACU|LGACU
LGACW|LGACW
LGF A|LGF.A
LGF B|LGF.B
LGH|LGH
LGHL|LGHL
LGHLW|LGHLW
LGI|LGI
LGIH|LGIH
LGL|LGL
LGL WS|LGL.WS
LGLV|LGLV
LGMK|LGMK
LGND|LGND
LGO|LGO
LGOV|LGOV
LGST|LGST
LGSTU|LGSTU
LGSTW|LGSTW
LGTO|LGTO
LGTOU|LGTOU
LGTOW|LGTOW
LGV|LGV
LGV U|LGV.U
LGV WS|LGV.WS
LGVC|LGVC
LGVCU|LGVCU
LGVCW|LGVCW
LGVN|LGVN
LH|LH
LHAA|LHAA
LHC|LHC
LHC U|LHC.U
LHCG|LHCG
LHDX|LHDX
LHX|LHX
LI|LI
LIAN|LIAN
LIBY|LIBY
LIBYU|LIBYU
LIBYW|LIBYW
LICY|LICY
LIDR|LIDR
LIDRW|LIDRW
LIFE|LIFE
LII|LII
LILA|LILA
LILAK|LILAK
LILM|LILM
LILMW|LILMW
LIN|LIN
LINC|LINC
LIND|LIND
LINK|LINK
LION|LION
LIONU|LIONU
LIONW|LIONW
LIQT|LIQT
LIT|LIT
LITB|LITB
LITE|LITE
LITM|LITM
LITT|LITT
LITTU|LITTU
LITTW|LITTW
LIVB|LIVB
LIVBU|LIVBU
LIVBW|LIVBW
LIVE|LIVE
LIVN|LIVN
LIXT|LIXT
LIXTW|LIXTW
LIZI|LIZI
LJAQ|LJAQ
LJAQU|LJAQU
LJAQW|LJAQW
LKCO|LKCO
LKFN|LKFN
LKOR|LKOR
LKQ|LKQ
LL|LL
LLAP|LLAP
LLAP WS|LLAP.WS
LLY|LLY
LMAT|LMAT
LMB|LMB
LMBS|LMBS
LMDX|LMDX
LMDXW|LMDXW
LMFA|LMFA
LMND|LMND
LMNL|LMNL
LMNR|LMNR
LMST|LMST
LMT|LMT
LNC|LNC
LNC PRD|LNCpD
LND|LND
LNG|LNG
LNKB|LNKB
LNN|LNN
LNSR|LNSR
LNT|LNT
LNTH|LNTH
LNW|LNW
LOAN|LOAN
LOB|LOB
LOCC|LOCC
LOCC U|LOCC.U
LOCC WS|LOCC.WS
LOCL|LOCL
LOCL WS|LOCL.WS
LOCO|LOCO
LODE|LODE
LOGI|LOGI
LOKM|LOKM
LOKM U|LOKM.U
LOKM WS|LOKM.WS
LOMA|LOMA
LONZ|LONZ
LOOP|LOOP
LOPE|LOPE
LOPP|LOPP
LOTZ|LOTZ
LOTZW|LOTZW
LOUP|LOUP
LOV|LOV
LOVE|LOVE
LOW|LOW
LPCN|LPCN
LPG|LPG
LPI|LPI
LPL|LPL
LPLA|LPLA
LPRO|LPRO
LPSN|LPSN
LPTH|LPTH
LPTV|LPTV
LPTX|LPTX
LPX|LPX
LQD|LQD
LQDA|LQDA
LQDB|LQDB
LQDH|LQDH
LQDI|LQDI
LQDT|LQDT
LQDW|LQDW
LQIG|LQIG
LRCX|LRCX
LRFC|LRFC
LRGE|LRGE
LRGF|LRGF
LRMR|LRMR
LRN|LRN
LRND|LRND
LRNZ|LRNZ
LSAF|LSAF
LSAK|LSAK
LSAT|LSAT
LSBK|LSBK
LSCC|LSCC
LSEA|LSEA
LSEAW|LSEAW
LSF|LSF
LSI|LSI
LSPD|LSPD
LSPR|LSPR
LSPRU|LSPRU
LSPRW|LSPRW
LSST|LSST
LSTA|LSTA
LSTR|LSTR
LSXMA|LSXMA
LSXMB|LSXMB
LSXMK|LSXMK
LTBR|LTBR
LTC|LTC
LTCH|LTCH
LTCHW|LTCHW
LTH|LTH
LTHM|LTHM
LTL|LTL
LTPZ|LTPZ
LTRN|LTRN
LTRPA|LTRPA
LTRPB|LTRPB
LTRX|LTRX
LTRY|LTRY
LTRYW|LTRYW
LU|LU
LUCD|LUCD
LUCY|LUCY
LUCYW|LUCYW
LULU|LULU
LUMN|LUMN
LUMO|LUMO
LUNA|LUNA
LUNG|LUNG
LUV|LUV
LUXH|LUXH
LVAC|LVAC
LVACU|LVACU
LVACW|LVACW
LVHD|LVHD
LVHI|LVHI
LVLU|LVLU
LVO|LVO
LVOL|LVOL
LVOX|LVOX
LVOXU|LVOXU
LVOXW|LVOXW
LVRA|LVRA
LVRAU|LVRAU
LVRAW|LVRAW
LVS|LVS
LVTX|LVTX
LVWR|LVWR
LVWR WS|LVWR.WS
LW|LW
LWAY|LWAY
LWLG|LWLG
LX|LX
LXEH|LXEH
LXFR|LXFR
LXP|LXP
LXP PRC|LXPpC
LXRX|LXRX
LXU|LXU
LYB|LYB
LYEL|LYEL
LYFE|LYFE
LYFT|LYFT
LYG|LYG
LYL|LYL
LYLT|LYLT
LYRA|LYRA
LYT|LYT
LYTS|LYTS
LYV|LYV
LZ|LZ
LZB|LZB
M|M
MA|MA
MAA|MAA
MAA PRI|MAApI
MAAX|MAAX
MAC|MAC
MACA|MACA
MACAU|MACAU
MACAW|MACAW
MACC|MACC
MACC U|MACC.U
MACK|MACK
MAG|MAG
MAGA|MAGA
MAIA|MAIA
MAIN|MAIN
MAKX|MAKX
MAMB|MAMB
MAN|MAN
MANH|MANH
MANU|MANU
MAPS|MAPS
MAPSW|MAPSW
MAQC|MAQC
MAQCU|MAQCU
MAQCW|MAQCW
MAR|MAR
MARA|MARA
MARB|MARB
MARK|MARK
MARPS|MARPS
MARZ|MARZ
MAS|MAS
MASI|MASI
MASS|MASS
MAT|MAT
MATV|MATV
MATW|MATW
MATX|MATX
MAV|MAV
MAX|MAX
MAXI|MAXI
MAXN|MAXN
MAXR|MAXR
MAYS|MAYS
MAYZ|MAYZ
MBAC|MBAC
MBAC U|MBAC.U
MBAC WS|MBAC.WS
MBB|MBB
MBBB|MBBB
MBCC|MBCC
MBCN|MBCN
MBI|MBI
MBIN|MBIN
MBINM|MBINM
MBINN|MBINN
MBINO|MBINO
MBINP|MBINP
MBIO|MBIO
MBLY|MBLY
MBND|MBND
MBNE|MBNE
MBNKP|MBNKP
MBOT|MBOT
MBOX|MBOX
MBRX|MBRX
MBSC|MBSC
MBSC U|MBSC.U
MBSC WS|MBSC.WS
MBSD|MBSD
MBTC|MBTC
MBTCR|MBTCR
MBTCU|MBTCU
MBUU|MBUU
MBWM|MBWM
MC|MC
MCAA|MCAA
MCAAU|MCAAU
MCAAW|MCAAW
MCAC|MCAC
MCACR|MCACR
MCACU|MCACU
MCACW|MCACW
MCAE|MCAE
MCAER|MCAER
MCAEU|MCAEU
MCAF|MCAF
MCAFR|MCAFR
MCAFU|MCAFU
MCAG|MCAG
MCAGR|MCAGR
MCAGU|MCAGU
MCB|MCB
MCBC|MCBC
MCBS|MCBS
MCD|MCD
MCFT|MCFT
MCG|MCG
MCH|MCH
MCHI|MCHI
MCHP|MCHP
MCHX|MCHX
MCI|MCI
MCK|MCK
MCLD|MCLD
MCLDW|MCLDW
MCN|MCN
MCO|MCO
MCR|MCR
MCRB|MCRB
MCRI|MCRI
MCRO|MCRO
MCS|MCS
MCSE|MCSE
MCVT|MCVT
MCW|MCW
MCY|MCY
MD|MD
MDB|MDB
MDC|MDC
MDCP|MDCP
MDEV|MDEV
MDGL|MDGL
MDGS|MDGS
MDGSW|MDGSW
MDH|MDH
MDH U|MDH.U
MDIA|MDIA
MDIV|MDIV
MDJH|MDJH
MDLZ|MDLZ
MDNA|MDNA
MDRR|MDRR
MDRRP|MDRRP
MDRX|MDRX
MDT|MDT
MDU|MDU
MDV|MDV
MDV PRA|MDVpA
MDVL|MDVL
MDWD|MDWD
MDWT|MDWT
MDXG|MDXG
MDXH|MDXH
MDY|MDY
MDYG|MDYG
MDYV|MDYV
ME|ME
MEAC|MEAC
MEACU|MEACU
MEACW|MEACW
MEAR|MEAR
MEC|MEC
MED|MED
MEDI|MEDI
MEDP|MEDP
MEDS|MEDS
MEG|MEG
MEGI|MEGI
MEGL|MEGL
MEI|MEI
MEIP|MEIP
MEKA|MEKA
MELI|MELI
MEM|MEM
MEME|MEME
MEOA|MEOA
MEOAU|MEOAU
MEOAW|MEOAW
MEOH|MEOH
MER PRK|MERpK
MERC|MERC
MESA|MESA
MESO|MESO
MET|MET
MET PRA|METpA
MET PRE|METpE
MET PRF|METpF
META|META
METC|METC
METCL|METCL
METV|METV
METX|METX
METXW|METXW
MEXX|MEXX
MF|MF
MFA|MFA
MFA PRB|MFApB
MFA PRC|MFApC
MFC|MFC
MFD|MFD
MFDX|MFDX
MFEM|MFEM
MFG|MFG
MFGP|MFGP
MFH|MFH
MFIC|MFIC
MFIN|MFIN
MFLX|MFLX
MFM|MFM
MFUL|MFUL
MFUS|MFUS
MFV|MFV
MG|MG
MGA|MGA
MGAM|MGAM
MGC|MGC
MGEE|MGEE
MGF|MGF
MGI|MGI
MGIC|MGIC
MGK|MGK
MGLD|MGLD
MGM|MGM
MGMT|MGMT
MGNI|MGNI
MGNX|MGNX
MGPI|MGPI
MGR|MGR
MGRB|MGRB
MGRC|MGRC
MGRD|MGRD
MGTA|MGTA
MGTX|MGTX
MGU|MGU
MGV|MGV
MGY|MGY
MGYR|MGYR
MH PRA|MHpA
MH PRC|MHpC
MH PRD|MHpD
MHD|MHD
MHF|MHF
MHH|MHH
MHI|MHI
MHK|MHK
MHLA|MHLA
MHLD|MHLD
MHN|MHN
MHNC|MHNC
MHO|MHO
MHUA|MHUA
MICS|MICS
MICT|MICT
MID|MID
MIDD|MIDD
MIDE|MIDE
MIDU|MIDU
MIG|MIG
MIGI|MIGI
MILN|MILN
MIMO|MIMO
MIMO WS|MIMO.WS
MIMO WSA|MIMO.WS.A
MIMO WSB|MIMO.WS.B
MIMO WSC|MIMO.WS.C
MIN|MIN
MINC|MINC
MIND|MIND
MINDP|MINDP
MINM|MINM
MINN|MINN
MINO|MINO
MINT|MINT
MINV|MINV
MIO|MIO
MIR|MIR
MIR WS|MIR.WS
MIRM|MIRM
MIRO|MIRO
MISL|MISL
MIST|MIST
MIT|MIT
MIT U|MIT.U
MITA|MITA
MITAU|MITAU
MITAW|MITAW
MITK|MITK
MITQ|MITQ
MITT|MITT
MITT PRA|MITTpA
MITT PRB|MITTpB
MITT PRC|MITTpC
MIXT|MIXT
MIY|MIY
MJ|MJ
MJUS|MJUS
MJXL|MJXL
MKC|MKC
MKC V|MKC.V
MKFG|MKFG
MKFG WS|MKFG.WS
MKL|MKL
MKSI|MKSI
MKTW|MKTW
MKTX|MKTX
ML|ML
ML WS|ML.WS
MLAB|MLAB
MLAC|MLAC
MLACU|MLACU
MLACW|MLACW
MLAI|MLAI
MLAIU|MLAIU
MLAIW|MLAIW
MLCO|MLCO
MLI|MLI
MLKN|MLKN
MLM|MLM
MLN|MLN
MLNK|MLNK
MLP|MLP
MLPA|MLPA
MLPB|MLPB
MLPO|MLPO
MLPR|MLPR
MLPX|MLPX
MLR|MLR
MLSS|MLSS
MLTX|MLTX
MLVF|MLVF
MMAT|MMAT
MMC|MMC
MMCA|MMCA
MMD|MMD
MMI|MMI
MMIN|MMIN
MMIT|MMIT
MMLG|MMLG
MMLP|MMLP
MMM|MMM
MMMB|MMMB
MMP|MMP
MMS|MMS
MMSB|MMSB
MMSC|MMSC
MMSI|MMSI
MMT|MMT
MMTM|MMTM
MMU|MMU
MMX|MMX
MMYT|MMYT
MNA|MNA
MNBD|MNBD
MNDO|MNDO
MNDY|MNDY
MNK|MNK
MNKD|MNKD
MNM|MNM
MNMD|MNMD
MNOV|MNOV
MNP|MNP
MNPR|MNPR
MNRL|MNRL
MNRO|MNRO
MNSB|MNSB
MNSBP|MNSBP
MNSO|MNSO
MNST|MNST
MNTK|MNTK
MNTN|MNTN
MNTN U|MNTN.U
MNTN WS|MNTN.WS
MNTS|MNTS
MNTSW|MNTSW
MNTV|MNTV
MNTX|MNTX
MO|MO
MOAT|MOAT
MOB|MOB
MOBBW|MOBBW
MOBQ|MOBQ
MOBQW|MOBQW
MOBV|MOBV
MOBVU|MOBVU
MOBVW|MOBVW
MOD|MOD
MODD|MODD
MODG|MODG
MODL|MODL
MODN|MODN
MODV|MODV
MOFG|MOFG
MOG A|MOG.A
MOG B|MOG.B
MOGO|MOGO
MOGU|MOGU
MOH|MOH
MOHR|MOHR
MOLN|MOLN
MOMO|MOMO
MON|MON
MONCU|MONCU
MONCW|MONCW
MOND|MOND
MOO|MOO
MOOD|MOOD
MOON|MOON
MOR|MOR
MORF|MORF
MORN|MORN
MORT|MORT
MOS|MOS
MOTE|MOTE
MOTG|MOTG
MOTI|MOTI
MOTO|MOTO
MOTS|MOTS
MOV|MOV
MOVE|MOVE
MOXC|MOXC
MP|MP
MPA|MPA
MPAA|MPAA
MPAC|MPAC
MPACR|MPACR
MPACU|MPACU
MPACW|MPACW
MPAY|MPAY
MPB|MPB
MPC|MPC
MPLN|MPLN
MPLN WS|MPLN.WS
MPLX|MPLX
MPRA|MPRA
MPRAU|MPRAU
MPRAW|MPRAW
MPRO|MPRO
MPTI|MPTI
MPV|MPV
MPW|MPW
MPWR|MPWR
MPX|MPX
MQ|MQ
MQT|MQT
MQY|MQY
MRAD|MRAD
MRAI|MRAI
MRAM|MRAM
MRBK|MRBK
MRC|MRC
MRCC|MRCC
MRCY|MRCY
MREO|MREO
MRGR|MRGR
MRIN|MRIN
MRK|MRK
MRKR|MRKR
MRM|MRM
MRNA|MRNA
MRND|MRND
MRNS|MRNS
MRO|MRO
MRSK|MRSK
MRSN|MRSN
MRTN|MRTN
MRTX|MRTX
MRUS|MRUS
MRVI|MRVI
MRVL|MRVL
MS|MS
MS PRA|MSpA
MS PRE|MSpE
MS PRF|MSpF
MS PRI|MSpI
MS PRK|MSpK
MS PRL|MSpL
MS PRO|MSpO
MS PRP|MSpP
MSA|MSA
MSAC|MSAC
MSACW|MSACW
MSB|MSB
MSBI|MSBI
MSBIP|MSBIP
MSC|MSC
MSCI|MSCI
MSD|MSD
MSDA|MSDA
MSDAU|MSDAU
MSDAW|MSDAW
MSEX|MSEX
MSFD|MSFD
MSFT|MSFT
MSFU|MSFU
MSGE|MSGE
MSGM|MSGM
MSGR|MSGR
MSGS|MSGS
MSI|MSI
MSM|MSM
MSMR|MSMR
MSN|MSN
MSOS|MSOS
MSOX|MSOX
MSPR|MSPR
MSPRW|MSPRW
MSPRZ|MSPRZ
MSSA|MSSA
MSSAR|MSSAR
MSSAU|MSSAU
MSSAW|MSSAW
MSTB|MSTB
MSTQ|MSTQ
MSTR|MSTR
MSVB|MSVB
MSVX|MSVX
MT|MT
MTA|MTA
MTAC|MTAC
MTACU|MTACU
MTACW|MTACW
MTAL|MTAL
MTAL U|MTAL.U
MTAL WS|MTAL.WS
MTB|MTB
MTB PRH|MTBpH
MTBC|MTBC
MTBCO|MTBCO
MTBCP|MTBCP
MTC|MTC
MTCH|MTCH
MTCN|MTCN
MTCR|MTCR
MTD|MTD
MTDR|MTDR
MTEK|MTEK
MTEKW|MTEKW
MTEM|MTEM
MTEST|MTEST
MTEST A|MTEST.A
MTEX|MTEX
MTG|MTG
MTGP|MTGP
MTH|MTH
MTL|MTL
MTL PR|MTLp
MTLS|MTLS
MTMT|MTMT
MTN|MTN
MTNB|MTNB
MTP|MTP
MTR|MTR
MTRN|MTRN
MTRX|MTRX
MTRY|MTRY
MTRYU|MTRYU
MTRYW|MTRYW
MTSI|MTSI
MTTR|MTTR
MTUL|MTUL
MTUM|MTUM
MTVC|MTVC
MTVC U|MTVC.U
MTVC WS|MTVC.WS
MTVR|MTVR
MTW|MTW
MTX|MTX
MTZ|MTZ
MU|MU
MUA|MUA
MUB|MUB
MUC|MUC
MUE|MUE
MUFG|MUFG
MUI|MUI
MUJ|MUJ
MULN|MULN
MUNI|MUNI
MUR|MUR
MURF|MURF
MURFU|MURFU
MURFW|MURFW
MUSA|MUSA
MUSI|MUSI
MUST|MUST
MUX|MUX
MVBF|MVBF
MVF|MVF
MVIS|MVIS
MVO|MVO
MVPS|MVPS
MVRL|MVRL
MVST|MVST
MVSTW|MVSTW
MVT|MVT
MVV|MVV
MWA|MWA
MX|MX
MXC|MXC
MXCT|MXCT
MXE|MXE
MXF|MXF
MXI|MXI
MXL|MXL
MYD|MYD
MYE|MYE
MYFW|MYFW
MYGN|MYGN
MYI|MYI
MYMD|MYMD
MYN|MYN
MYNA|MYNA
MYNZ|MYNZ
MYO|MYO
MYOV|MYOV
MYPS|MYPS
MYPSW|MYPSW
MYRG|MYRG
MYSZ|MYSZ
MYTE|MYTE
MYY|MYY
MZZ|MZZ
NA|NA
NAAC|NAAC
NAACU|NAACU
NAACW|NAACW
NAAS|NAAS
NABL|NABL
NAC|NAC
NACP|NACP
NAD|NAD
NAII|NAII
NAIL|NAIL
NAK|NAK
NAMS|NAMS
NAMSW|NAMSW
NAN|NAN
NANR|NANR
NAOV|NAOV
NAPA|NAPA
NAPR|NAPR
NARI|NARI
NAT|NAT
NATH|NATH
NATI|NATI
NATR|NATR
NAUT|NAUT
NAVB|NAVB
NAVI|NAVI
NAZ|NAZ
NBB|NBB
NBCC|NBCC
NBCM|NBCM
NBCT|NBCT
NBDS|NBDS
NBH|NBH
NBHC|NBHC
NBIX|NBIX
NBN|NBN
NBO|NBO
NBR|NBR
NBRV|NBRV
NBSE|NBSE
NBST|NBST
NBSTU|NBSTU
NBSTW|NBSTW
NBTB|NBTB
NBTX|NBTX
NBW|NBW
NBXG|NBXG
NBY|NBY
NC|NC
NCA|NCA
NCAC|NCAC
NCACU|NCACU
NCACW|NCACW
NCLH|NCLH
NCMI|NCMI
NCNA|NCNA
NCNO|NCNO
NCPL|NCPL
NCPLW|NCPLW
NCR|NCR
NCRA|NCRA
NCSM|NCSM
NCTY|NCTY
NCV|NCV
NCV PRA|NCVpA
NCZ|NCZ
NCZ PRA|NCZpA
NDAQ|NDAQ
NDIV|NDIV
NDJI|NDJI
NDLS|NDLS
NDMO|NDMO
NDP|NDP
NDRA|NDRA
NDSN|NDSN
NDVG|NDVG
NE|NE
NEA|NEA
NEAR|NEAR
NECB|NECB
NEE|NEE
NEE PRN|NEEpN
NEE PRP|NEEpP
NEE PRQ|NEEpQ
NEE PRR|NEEpR
NEGG|NEGG
NEM|NEM
NEN|NEN
NEO|NEO
NEOG|NEOG
NEON|NEON
NEOV|NEOV
NEOVW|NEOVW
NEP|NEP
NEPH|NEPH
NEPT|NEPT
NERD|NERD
NERV|NERV
NESR|NESR
NESRW|NESRW
NET|NET
NETC|NETC
NETC U|NETC.U
NETC WS|NETC.WS
NETI|NETI
NETL|NETL
NETZ|NETZ
NEU|NEU
NEWP|NEWP
NEWR|NEWR
NEWT|NEWT
NEWTL|NEWTL
NEWTZ|NEWTZ
NEX|NEX
NEXA|NEXA
NEXI|NEXI
NEXT|NEXT
NFBK|NFBK
NFE|NFE
NFG|NFG
NFGC|NFGC
NFJ|NFJ
NFLT|NFLT
NFLX|NFLX
NFNT|NFNT
NFNT U|NFNT.U
NFNT WS|NFNT.WS
NFRA|NFRA
NFTY|NFTY
NFTZ|NFTZ
NFYS|NFYS
NFYS U|NFYS.U
NFYS WS|NFYS.WS
NG|NG
NGC|NGC
NGC U|NGC.U
NGC WS|NGC.WS
NGD|NGD
NGE|NGE
NGG|NGG
NGL|NGL
NGL PRB|NGLpB
NGL PRC|NGLpC
NGM|NGM
NGMS|NGMS
NGS|NGS
NGVC|NGVC
NGVT|NGVT
NH|NH
NHC|NHC
NHI|NHI
NHIC|NHIC
NHICU|NHICU
NHICW|NHICW
NHS|NHS
NHTC|NHTC
NHWK|NHWK
NI|NI
NI PRB|NIpB
NIB|NIB
NIC|NIC
NICE|NICE
NICK|NICK
NID|NID
NIE|NIE
NILE|NILE
NILE PRD|NILEpD
NIM|NIM
NIMC|NIMC
NINE|NINE
NIO|NIO
NIQ|NIQ
NISN|NISN
NIU|NIU
NIWM|NIWM
NJAN|NJAN
NJR|NJR
NJUL|NJUL
NKE|NKE
NKEL|NKEL
NKEQ|NKEQ
NKG|NKG
NKLA|NKLA
NKSH|NKSH
NKTR|NKTR
NKTX|NKTX
NKX|NKX
NL|NL
NLR|NLR
NLS|NLS
NLSP|NLSP
NLSPW|NLSPW
NLTX|NLTX
NLY|NLY
NLY PRF|NLYpF
NLY PRG|NLYpG
NLY PRI|NLYpI
NM|NM
NM PRG|NMpG
NM PRH|NMpH
NMAI|NMAI
NMCO|NMCO
NMFC|NMFC
NMG|NMG
NMI|NMI
NMIH|NMIH
NMK PRB|NMKpB
NMK PRC|NMKpC
NML|NML
NMM|NMM
NMR|NMR
NMRD|NMRD
NMRK|NMRK
NMS|NMS
NMT|NMT
NMTC|NMTC
NMTR|NMTR
NMZ|NMZ
NN|NN
NNAVW|NNAVW
NNBR|NNBR
NNDM|NNDM
NNI|NNI
NNN|NNN
NNOX|NNOX
NNVC|NNVC
NNY|NNY
NOA|NOA
NOAH|NOAH
NOBL|NOBL
NOC|NOC
NOCT|NOCT
NODK|NODK
NOG|NOG
NOGN|NOGN
NOGNW|NOGNW
NOK|NOK
NOM|NOM
NOMD|NOMD
NOPE|NOPE
NORW|NORW
NOTE|NOTE
NOTE WS|NOTE.WS
NOTV|NOTV
NOV|NOV
NOVA|NOVA
NOVN|NOVN
NOVT|NOVT
NOVV|NOVV
NOVVR|NOVVR
NOVVU|NOVVU
NOVVW|NOVVW
NOVZ|NOVZ
NOW|NOW
NPAB|NPAB
NPABU|NPABU
NPABW|NPABW
NPCE|NPCE
NPCT|NPCT
NPFD|NPFD
NPK|NPK
NPO|NPO
NPV|NPV
NQP|NQP
NR|NR
NRAC|NRAC
NRACU|NRACU
NRACW|NRACW
NRBO|NRBO
NRC|NRC
NRDS|NRDS
NRDY|NRDY
NRDY WS|NRDY.WS
NREF|NREF
NREF PRA|NREFpA
NRG|NRG
NRGD|NRGD
NRGU|NRGU
NRGV|NRGV
NRGX|NRGX
NRIM|NRIM
NRIX|NRIX
NRK|NRK
NRO|NRO
NRP|NRP
NRSN|NRSN
NRSNW|NRSNW
NRT|NRT
NRUC|NRUC
NRXP|NRXP
NRXPW|NRXPW
NS|NS
NS PRA|NSpA
NS PRB|NSpB
NS PRC|NSpC
NSA|NSA
NSA PRA|NSApA
NSC|NSC
NSCS|NSCS
NSIT|NSIT
NSL|NSL
NSP|NSP
NSPI|NSPI
NSPL|NSPL
NSPR|NSPR
NSPY|NSPY
NSS|NSS
NSSC|NSSC
NSTB|NSTB
NSTB U|NSTB.U
NSTB WS|NSTB.WS
NSTC|NSTC
NSTC U|NSTC.U
NSTD|NSTD
NSTD U|NSTD.U
NSTD WS|NSTD.WS
NSTG|NSTG
NSTS|NSTS
NSYS|NSYS
NTAP|NTAP
NTB|NTB
NTCO|NTCO
NTCT|NTCT
NTES|NTES
NTEST|NTEST
NTEST G|NTEST.G
NTEST H|NTEST.H
NTEST I|NTEST.I
NTEST J|NTEST.J
NTEST K|NTEST.K
NTEST L|NTEST.L
NTEST M|NTEST.M
NTEST N|NTEST.N
NTEST O|NTEST.O
NTEST P|NTEST.P
NTEST Q|NTEST.Q
NTEST Y|NTEST.Y
NTEST Z|NTEST.Z
NTG|NTG
NTGR|NTGR
NTIC|NTIC
NTIP|NTIP
NTKI|NTKI
NTLA|NTLA
NTNX|NTNX
NTR|NTR
NTRA|NTRA
NTRB|NTRB
NTRBW|NTRBW
NTRS|NTRS
NTRSO|NTRSO
NTSE|NTSE
NTSI|NTSI
NTST|NTST
NTSX|NTSX
NTWK|NTWK
NTZ|NTZ
NTZG|NTZG
NU|NU
NUAG|NUAG
NUBD|NUBD
NUBI|NUBI
NUBIU|NUBIU
NUBIW|NUBIW
NUDM|NUDM
NUDV|NUDV
NUE|NUE
NUEM|NUEM
NUGO|NUGO
NUGT|NUGT
NUHY|NUHY
NULC|NULC
NULG|NULG
NULV|NULV
NUMG|NUMG
NUMV|NUMV
NUO|NUO
NURE|NURE
NURO|NURO
NUS|NUS
NUSA|NUSA
NUSC|NUSC
NUSI|NUSI
NUTX|NUTX
NUV|NUV
NUVA|NUVA
NUVB|NUVB
NUVB WS|NUVB.WS
NUVL|NUVL
NUW|NUW
NUWE|NUWE
NUZE|NUZE
NVAC|NVAC
NVACR|NVACR
NVACW|NVACW
NVAX|NVAX
NVBT|NVBT
NVBW|NVBW
NVCN|NVCN
NVCR|NVCR
NVCT|NVCT
NVDA|NVDA
NVDS|NVDS
NVEC|NVEC
NVEE|NVEE
NVEI|NVEI
NVFY|NVFY
NVG|NVG
NVGS|NVGS
NVIV|NVIV
NVMI|NVMI
NVNO|NVNO
NVNOW|NVNOW
NVO|NVO
NVOS|NVOS
NVQ|NVQ
NVR|NVR
NVRO|NVRO
NVS|NVS
NVSA|NVSA
NVSAU|NVSAU
NVSAW|NVSAW
NVST|NVST
NVT|NVT
NVTA|NVTA
NVTS|NVTS
NVVE|NVVE
NVVEW|NVVEW
NVX|NVX
NWBI|NWBI
NWE|NWE
NWFL|NWFL
NWG|NWG
NWL|NWL
NWLG|NWLG
NWLI|NWLI
NWN|NWN
NWPX|NWPX
NWS|NWS
NWSA|NWSA
NWTN|NWTN
NWTNW|NWTNW
NX|NX
NXC|NXC
NXDT|NXDT
NXDT PRA|NXDTpA
NXE|NXE
NXG|NXG
NXGL|NXGL
NXGLW|NXGLW
NXGN|NXGN
NXJ|NXJ
NXL|NXL
NXLIW|NXLIW
NXN|NXN
NXP|NXP
NXPI|NXPI
NXPL|NXPL
NXPLW|NXPLW
NXRT|NXRT
NXST|NXST
NXTC|NXTC
NXTE|NXTE
NXTG|NXTG
NXTP|NXTP
NYAX|NYAX
NYC|NYC
NYCB|NYCB
NYCB PRA|NYCBpA
NYCB PRU|NYCBpU
NYF|NYF
NYMT|NYMT
NYMTL|NYMTL
NYMTM|NYMTM
NYMTN|NYMTN
NYMTZ|NYMTZ
NYMX|NYMX
NYT|NYT
NYXH|NYXH
NZAC|NZAC
NZF|NZF
NZRO|NZRO
NZUS|NZUS
O|O
OABI|OABI
OABIW|OABIW
OACP|OACP
OAEM|OAEM
OAIE|OAIE
OAIM|OAIM
OAK PRA|OAKpA
OAK PRB|OAKpB
OALC|OALC
OARK|OARK
OB|OB
OBE|OBE
OBIL|OBIL
OBLG|OBLG
OBND|OBND
OBNK|OBNK
OBOR|OBOR
OBSV|OBSV
OBT|OBT
OC|OC
OCAX|OCAX
OCAXU|OCAXU
OCAXW|OCAXW
OCC|OCC
OCCI|OCCI
OCCIN|OCCIN
OCCIO|OCCIO
OCEN|OCEN
OCFC|OCFC
OCFCP|OCFCP
OCFT|OCFT
OCG|OCG
OCGN|OCGN
OCIO|OCIO
OCN|OCN
OCSL|OCSL
OCTT|OCTT
OCTW|OCTW
OCTZ|OCTZ
OCUL|OCUL
OCUP|OCUP
OCX|OCX
ODC|ODC
ODDS|ODDS
ODFL|ODFL
ODP|ODP
ODV|ODV
OEC|OEC
OEF|OEF
OEPW|OEPW
OEPWU|OEPWU
OEPWW|OEPWW
OESX|OESX
OEUR|OEUR
OFC|OFC
OFED|OFED
OFG|OFG
OFIX|OFIX
OFLX|OFLX
OFS|OFS
OFSSH|OFSSH
OG|OG
OGCP|OGCP
OGE|OGE
OGEN|OGEN
OGI|OGI
OGIG|OGIG
OGN|OGN
OGS|OGS
OHAA|OHAA
OHAAU|OHAAU
OHAAW|OHAAW
OHI|OHI
OI|OI
OIA|OIA
OIG|OIG
OIH|OIH
OII|OII
OIIM|OIIM
OIL|OIL
OILD|OILD
OILK|OILK
OILU|OILU
OIS|OIS
OKE|OKE
OKTA|OKTA
OKYO|OKYO
OLB|OLB
OLED|OLED
OLIT|OLIT
OLITU|OLITU
OLITW|OLITW
OLK|OLK
OLLI|OLLI
OLMA|OLMA
OLN|OLN
OLO|OLO
OLP|OLP
OLPX|OLPX
OM|OM
OMAB|OMAB
OMC|OMC
OMCL|OMCL
OMEG|OMEG
OMER|OMER
OMEX|OMEX
OMF|OMF
OMFL|OMFL
OMFS|OMFS
OMGA|OMGA
OMI|OMI
OMIC|OMIC
OMQS|OMQS
ON|ON
ONB|ONB
ONBPO|ONBPO
ONBPP|ONBPP
ONCR|ONCR
ONCS|ONCS
ONCT|ONCT
ONCY|ONCY
OND|OND
ONDS|ONDS
ONEM|ONEM
ONEO|ONEO
ONEQ|ONEQ
ONEV|ONEV
ONEW|ONEW
ONEY|ONEY
ONFO|ONFO
ONFOW|ONFOW
ONG|ONG
ONL|ONL
ONLN|ONLN
ONOF|ONOF
ONON|ONON
ONTF|ONTF
ONTO|ONTO
ONTX|ONTX
ONVO|ONVO
ONYX|ONYX
ONYXU|ONYXU
ONYXW|ONYXW
OOMA|OOMA
OOTO|OOTO
OP|OP
OPA|OPA
OPA U|OPA.U
OPA WS|OPA.WS
OPAD|OPAD
OPAD WS|OPAD.WS
OPAL|OPAL
OPALW|OPALW
OPBK|OPBK
OPCH|OPCH
OPEN|OPEN
OPER|OPER
OPFI|OPFI
OPFI WS|OPFI.WS
OPGN|OPGN
OPHC|OPHC
OPI|OPI
OPINL|OPINL
OPK|OPK
OPNT|OPNT
OPOF|OPOF
OPP|OPP
OPP PRA|OPPpA
OPP PRB|OPPpB
OPPX|OPPX
OPRA|OPRA
OPRT|OPRT
OPRX|OPRX
OPT|OPT
OPTN|OPTN
OPTT|OPTT
OPY|OPY
OR|OR
ORA|ORA
ORAN|ORAN
ORC|ORC
ORCC|ORCC
ORCL|ORCL
ORFN|ORFN
ORGN|ORGN
ORGNW|ORGNW
ORGO|ORGO
ORGS|ORGS
ORI|ORI
ORIA|ORIA
ORIAU|ORIAU
ORIAW|ORIAW
ORIC|ORIC
ORLA|ORLA
ORLY|ORLY
ORMP|ORMP
ORN|ORN
ORRF|ORRF
ORTX|ORTX
OSBC|OSBC
OSCR|OSCR
OSCV|OSCV
OSEA|OSEA
OSG|OSG
OSH|OSH
OSI|OSI
OSI U|OSI.U
OSI WS|OSI.WS
OSIS|OSIS
OSK|OSK
OSPN|OSPN
OSS|OSS
OST|OST
OSTK|OSTK
OSTR|OSTR
OSTRU|OSTRU
OSTRW|OSTRW
OSUR|OSUR
OSW|OSW
OTEC|OTEC
OTECU|OTECU
OTECW|OTECW
OTEX|OTEX
OTIC|OTIC
OTIS|OTIS
OTLK|OTLK
OTLY|OTLY
OTMO|OTMO
OTMOW|OTMOW
OTRK|OTRK
OTRKP|OTRKP
OTTR|OTTR
OUNZ|OUNZ
OUSA|OUSA
OUSM|OUSM
OUST|OUST
OUST WS|OUST.WS
OUT|OUT
OVB|OVB
OVBC|OVBC
OVF|OVF
OVID|OVID
OVL|OVL
OVLH|OVLH
OVLY|OVLY
OVM|OVM
OVS|OVS
OVT|OVT
OVV|OVV
OWL|OWL
OWLT|OWLT
OWLT WS|OWLT.WS
OWNS|OWNS
OXAC|OXAC
OXACU|OXACU
OXACW|OXACW
OXBR|OXBR
OXBRW|OXBRW
OXLC|OXLC
OXLCL|OXLCL
OXLCM|OXLCM
OXLCN|OXLCN
OXLCO|OXLCO
OXLCP|OXLCP
OXLCZ|OXLCZ
OXM|OXM
OXSQ|OXSQ
OXSQG|OXSQG
OXSQL|OXSQL
OXSQZ|OXSQZ
OXUS|OXUS
OXUSU|OXUSU
OXUSW|OXUSW
OXY|OXY
OXY WS|OXY.WS
OYST|OYST
OZ|OZ
OZK|OZK
OZKAP|OZKAP
OZON|OZON
PAA|PAA
PAAS|PAAS
PAB|PAB
PABU|PABU
PAC|PAC
PACB|PACB
PACI|PACI
PACI U|PACI.U
PACI WS|PACI.WS
PACK|PACK
PACW|PACW
PACWP|PACWP
PACX|PACX
PACXU|PACXU
PACXW|PACXW
PAFO|PAFO
PAFOR|PAFOR
PAFOU|PAFOU
PAG|PAG
PAGP|PAGP
PAGS|PAGS
PAHC|PAHC
PAI|PAI
PAK|PAK
PALC|PALC
PALI|PALI
PALL|PALL
PALT|PALT
PAM|PAM
PAMC|PAMC
PANA|PANA
PANL|PANL
PANW|PANW
PAPR|PAPR
PAR|PAR
PARA|PARA
PARAA|PARAA
PARAP|PARAP
PARR|PARR
PASG|PASG
PATH|PATH
PATI|PATI
PATK|PATK
PAUG|PAUG
PAVE|PAVE
PAVM|PAVM
PAVMZ|PAVMZ
PAWZ|PAWZ
PAX|PAX
PAXS|PAXS
PAY|PAY
PAYA|PAYA
PAYC|PAYC
PAYO|PAYO
PAYOW|PAYOW
PAYS|PAYS
PAYX|PAYX
PB|PB
PBA|PBA
PBAX|PBAX
PBAXU|PBAXU
PBAXW|PBAXW
PBBK|PBBK
PBD|PBD
PBDC|PBDC
PBDM|PBDM
PBE|PBE
PBEE|PBEE
PBF|PBF
PBFS|PBFS
PBH|PBH
PBHC|PBHC
PBI|PBI
PBI PRB|PBIpB
PBJ|PBJ
PBLA|PBLA
PBND|PBND
PBP|PBP
PBPB|PBPB
PBR|PBR
PBR A|PBR.A
PBS|PBS
PBSM|PBSM
PBT|PBT
PBTP|PBTP
PBTS|PBTS
PBUG|PBUG
PBUS|PBUS
PBW|PBW
PBYI|PBYI
PCAR|PCAR
PCB|PCB
PCCT|PCCT
PCCTU|PCCTU
PCCTW|PCCTW
PCEF|PCEF
PCF|PCF
PCG|PCG
PCG PRA|PCGpA
PCG PRB|PCGpB
PCG PRC|PCGpC
PCG PRD|PCGpD
PCG PRE|PCGpE
PCG PRG|PCGpG
PCG PRH|PCGpH
PCG PRI|PCGpI
PCGU|PCGU
PCH|PCH
PCK|PCK
PCM|PCM
PCN|PCN
PCOR|PCOR
PCPC|PCPC
PCPC U|PCPC.U
PCQ|PCQ
PCRX|PCRX
PCSA|PCSA
PCSB|PCSB
PCT|PCT
PCTI|PCTI
PCTTU|PCTTU
PCTTW|PCTTW
PCTY|PCTY
PCVX|PCVX
PCX|PCX
PCXCU|PCXCU
PCXCW|PCXCW
PCY|PCY
PCYG|PCYG
PCYO|PCYO
PD|PD
PDBA|PDBA
PDBC|PDBC
PDCE|PDCE
PDCO|PDCO
PDD|PDD
PDEC|PDEC
PDEX|PDEX
PDFS|PDFS
PDI|PDI
PDLB|PDLB
PDM|PDM
PDN|PDN
PDO|PDO
PDOT|PDOT
PDOT U|PDOT.U
PDOT WS|PDOT.WS
PDP|PDP
PDS|PDS
PDSB|PDSB
PDT|PDT
PEAK|PEAK
PEAR|PEAR
PEARW|PEARW
PEB|PEB
PEB PRE|PEBpE
PEB PRF|PEBpF
PEB PRG|PEBpG
PEB PRH|PEBpH
PEBK|PEBK
PEBO|PEBO
PECO|PECO
PED|PED
PEG|PEG
PEGA|PEGA
PEGR|PEGR
PEGRU|PEGRU
PEGRW|PEGRW
PEGY|PEGY
PEI|PEI
PEI PRB|PEIpB
PEI PRC|PEIpC
PEI PRD|PEIpD
PEJ|PEJ
PEN|PEN
PENN|PENN
PEO|PEO
PEP|PEP
PEPG|PEPG
PEPL|PEPL
PEPLU|PEPLU
PEPLW|PEPLW
PERF|PERF
PERF WS|PERF.WS
PERI|PERI
PESI|PESI
PET|PET
PETQ|PETQ
PETS|PETS
PETV|PETV
PETVW|PETVW
PETWW|PETWW
PETZ|PETZ
PEV|PEV
PEX|PEX
PEXL|PEXL
PEY|PEY
PEZ|PEZ
PFBC|PFBC
PFC|PFC
PFD|PFD
PFDR|PFDR
PFDRU|PFDRU
PFDRW|PFDRW
PFE|PFE
PFEB|PFEB
PFEL|PFEL
PFES|PFES
PFF|PFF
PFFA|PFFA
PFFD|PFFD
PFFL|PFFL
PFFR|PFFR
PFFV|PFFV
PFG|PFG
PFGC|PFGC
PFH|PFH
PFHD|PFHD
PFI|PFI
PFIE|PFIE
PFIG|PFIG
PFIN|PFIN
PFIS|PFIS
PFIX|PFIX
PFL|PFL
PFLD|PFLD
PFLT|PFLT
PFM|PFM
PFMT|PFMT
PFN|PFN
PFO|PFO
PFRL|PFRL
PFS|PFS
PFSI|PFSI
PFSW|PFSW
PFTA|PFTA
PFTAU|PFTAU
PFTAW|PFTAW
PFUT|PFUT
PFX|PFX
PFXF|PFXF
PFXNL|PFXNL
PFXNZ|PFXNZ
PG|PG
PGAL|PGAL
PGC|PGC
PGEN|PGEN
PGF|PGF
PGHY|PGHY
PGJ|PGJ
PGM|PGM
PGNY|PGNY
PGP|PGP
PGR|PGR
PGRE|PGRE
PGRO|PGRO
PGRU|PGRU
PGRW|PGRW
PGRWU|PGRWU
PGRWW|PGRWW
PGSS|PGSS
PGSS U|PGSS.U
PGSS WS|PGSS.WS
PGTI|PGTI
PGX|PGX
PGY|PGY
PGYWW|PGYWW
PGZ|PGZ
PH|PH
PHAR|PHAR
PHAT|PHAT
PHB|PHB
PHCF|PHCF
PHD|PHD
PHDG|PHDG
PHG|PHG
PHGE|PHGE
PHGE U|PHGE.U
PHGE WS|PHGE.WS
PHI|PHI
PHIO|PHIO
PHK|PHK
PHM|PHM
PHO|PHO
PHR|PHR
PHT|PHT
PHUN|PHUN
PHUNW|PHUNW
PHVS|PHVS
PHX|PHX
PHYL|PHYL
PHYS|PHYS
PHYT|PHYT
PHYT U|PHYT.U
PHYT WS|PHYT.WS
PI|PI
PIAI|PIAI
PIAI U|PIAI.U
PIAI WS|PIAI.WS
PICB|PICB
PICC|PICC
PICC U|PICC.U
PICK|PICK
PID|PID
PIE|PIE
PIFI|PIFI
PII|PII
PIII|PIII
PIIIW|PIIIW
PIK|PIK
PILL|PILL
PIM|PIM
PIN|PIN
PINC|PINC
PINE|PINE
PINK|PINK
PINS|PINS
PIO|PIO
PIPR|PIPR
PIRS|PIRS
PIXY|PIXY
PIZ|PIZ
PJAN|PJAN
PJP|PJP
PJT|PJT
PJUL|PJUL
PJUN|PJUN
PK|PK
PKB|PKB
PKBK|PKBK
PKBO|PKBO
PKBOW|PKBOW
PKE|PKE
PKG|PKG
PKI|PKI
PKOH|PKOH
PKW|PKW
PKX|PKX
PL|PL
PL WS|PL.WS
PLAB|PLAB
PLAG|PLAG
PLAO|PLAO
PLAOU|PLAOU
PLAOW|PLAOW
PLAT|PLAT
PLAY|PLAY
PLBC|PLBC
PLBY|PLBY
PLCE|PLCE
PLD|PLD
PLDR|PLDR
PLG|PLG
PLL|PLL
PLM|PLM
PLMI|PLMI
PLMIU|PLMIU
PLMIW|PLMIW
PLMR|PLMR
PLNT|PLNT
PLOW|PLOW
PLPC|PLPC
PLRG|PLRG
PLRX|PLRX
PLSE|PLSE
PLTK|PLTK
PLTL|PLTL
PLTM|PLTM
PLTNU|PLTNU
PLTR|PLTR
PLUG|PLUG
PLUR|PLUR
PLUS|PLUS
PLW|PLW
PLX|PLX
PLXP|PLXP
PLXS|PLXS
PLYA|PLYA
PLYM|PLYM
PLYM PRA|PLYMpA
PM|PM
PMAR|PMAR
PMAY|PMAY
PMCB|PMCB
PMD|PMD
PME|PME
PMF|PMF
PMGM|PMGM
PMGMU|PMGMU
PMGMW|PMGMW
PML|PML
PMM|PMM
PMN|PMN
PMO|PMO
PMT|PMT
PMT PRA|PMTpA
PMT PRB|PMTpB
PMT PRC|PMTpC
PMTS|PMTS
PMVP|PMVP
PMX|PMX
PNAC|PNAC
PNACR|PNACR
PNACU|PNACU
PNACW|PNACW
PNBK|PNBK
PNC|PNC
PNF|PNF
PNFP|PNFP
PNFPP|PNFPP
PNI|PNI
PNM|PNM
PNNT|PNNT
PNOV|PNOV
PNQI|PNQI
PNR|PNR
PNRG|PNRG
PNT|PNT
PNTG|PNTG
PNTM|PNTM
PNTM U|PNTM.U
PNTM WS|PNTM.WS
PNW|PNW
POAI|POAI
POCI|POCI
POCT|POCT
PODD|PODD
POET|POET
POL|POL
POL WS|POL.WS
POLA|POLA
POND|POND
POND U|POND.U
POND WS|POND.WS
PONO|PONO
PONOU|PONOU
PONOW|PONOW
POOL|POOL
POR|POR
PORT|PORT
PORT U|PORT.U
PORT WS|PORT.WS
POSH|POSH
POST|POST
POTX|POTX
POW|POW
POWI|POWI
POWL|POWL
POWRU|POWRU
POWRW|POWRW
POWW|POWW
POWWP|POWWP
PP|PP
PPA|PPA
PPBI|PPBI
PPBT|PPBT
PPC|PPC
PPG|PPG
PPH|PPH
PPHP|PPHP
PPHPR|PPHPR
PPHPU|PPHPU
PPHPW|PPHPW
PPI|PPI
PPIH|PPIH
PPL|PPL
PPLT|PPLT
PPSI|PPSI
PPT|PPT
PPTA|PPTA
PPTY|PPTY
PPYA|PPYA
PPYAU|PPYAU
PPYAW|PPYAW
PQDI|PQDI
PQIN|PQIN
PR|PR
PRA|PRA
PRAA|PRAA
PRAX|PRAX
PRAY|PRAY
PRBM|PRBM
PRBM U|PRBM.U
PRCH|PRCH
PRCT|PRCT
PRDO|PRDO
PRDS|PRDS
PRE|PRE
PRE PRJ|PREpJ
PREF|PREF
PRENW|PRENW
PRF|PRF
PRFT|PRFT
PRFX|PRFX
PRFZ|PRFZ
PRG|PRG
PRGO|PRGO
PRGS|PRGS
PRH|PRH
PRI|PRI
PRIF PRD|PRIFpD
PRIF PRF|PRIFpF
PRIF PRG|PRIFpG
PRIF PRH|PRIFpH
PRIF PRI|PRIFpI
PRIF PRJ|PRIFpJ
PRIF PRK|PRIFpK
PRIF PRL|PRIFpL
PRIM|PRIM
PRK|PRK
PRLB|PRLB
PRLD|PRLD
PRLH|PRLH
PRLHU|PRLHU
PRLHW|PRLHW
PRM|PRM
PRME|PRME
PRMW|PRMW
PRN|PRN
PRNT|PRNT
PRO|PRO
PROC|PROC
PROCW|PROCW
PROF|PROF
PROK|PROK
PROV|PROV
PRPC|PRPC
PRPC U|PRPC.U
PRPC WS|PRPC.WS
PRPH|PRPH
PRPL|PRPL
PRPO|PRPO
PRQR|PRQR
PRS|PRS
PRSO|PRSO
PRSR|PRSR
PRSRU|PRSRU
PRSRW|PRSRW
PRST|PRST
PRSTW|PRSTW
PRT|PRT
PRTA|PRTA
PRTC|PRTC
PRTG|PRTG
PRTH|PRTH
PRTK|PRTK
PRTS|PRTS
PRTY|PRTY
PRU|PRU
PRVA|PRVA
PRVB|PRVB
PSA|PSA
PSA PRF|PSApF
PSA PRG|PSApG
PSA PRH|PSApH
PSA PRI|PSApI
PSA PRJ|PSApJ
PSA PRK|PSApK
PSA PRL|PSApL
PSA PRM|PSApM
PSA PRN|PSApN
PSA PRO|PSApO
PSA PRP|PSApP
PSA PRQ|PSApQ
PSA PRR|PSApR
PSA PRS|PSApS
PSAG|PSAG
PSAGU|PSAGU
PSAGW|PSAGW
PSB PRX|PSBpX
PSB PRY|PSBpY
PSB PRZ|PSBpZ
PSC|PSC
PSCC|PSCC
PSCD|PSCD
PSCE|PSCE
PSCF|PSCF
PSCH|PSCH
PSCI|PSCI
PSCJ|PSCJ
PSCM|PSCM
PSCQ|PSCQ
PSCT|PSCT
PSCU|PSCU
PSCW|PSCW
PSCX|PSCX
PSDN|PSDN
PSEC|PSEC
PSEC PRA|PSECpA
PSEP|PSEP
PSET|PSET
PSF|PSF
PSFD|PSFD
PSFE|PSFE
PSFE WS|PSFE.WS
PSFF|PSFF
PSFJ|PSFJ
PSFM|PSFM
PSFO|PSFO
PSHG|PSHG
PSI|PSI
PSIL|PSIL
PSJ|PSJ
PSK|PSK
PSL|PSL
PSLV|PSLV
PSMB|PSMB
PSMC|PSMC
PSMD|PSMD
PSMG|PSMG
PSMJ|PSMJ
PSMM|PSMM
PSMO|PSMO
PSMR|PSMR
PSMT|PSMT
PSN|PSN
PSNL|PSNL
PSNY|PSNY
PSNYW|PSNYW
PSO|PSO
PSP|PSP
PSPC|PSPC
PSPC U|PSPC.U
PSPC WS|PSPC.WS
PSQ|PSQ
PSR|PSR
PST|PST
PSTG|PSTG
PSTL|PSTL
PSTP|PSTP
PSTV|PSTV
PSTX|PSTX
PSX|PSX
PSYK|PSYK
PT|PT
PTA|PTA
PTBD|PTBD
PTC|PTC
PTCT|PTCT
PTE|PTE
PTEN|PTEN
PTEST|PTEST
PTEST W|PTEST.W
PTEST X|PTEST.X
PTEST Y|PTEST.Y
PTEST Z|PTEST.Z
PTEU|PTEU
PTF|PTF
PTGX|PTGX
PTH|PTH
PTIN|PTIN
PTIX|PTIX
PTIXW|PTIXW
PTLC|PTLC
PTLO|PTLO
PTMC|PTMC
PTMN|PTMN
PTN|PTN
PTNQ|PTNQ
PTNR|PTNR
PTOC|PTOC
PTOCU|PTOCU
PTOCW|PTOCW
PTON|PTON
PTPI|PTPI
PTRA|PTRA
PTRB|PTRB
PTRS|PTRS
PTSI|PTSI
PTVE|PTVE
PTWO|PTWO
PTWOU|PTWOU
PTWOW|PTWOW
PTY|PTY
PUBM|PUBM
PUCK|PUCK
PUCKU|PUCKU
PUCKW|PUCKW
PUI|PUI
PUK|PUK
PULM|PULM
PULS|PULS
PUMP|PUMP
PUNK|PUNK
PUTW|PUTW
PUYI|PUYI
PV|PV
PV U|PV.U
PV WS|PV.WS
PVAL|PVAL
PVBC|PVBC
PVH|PVH
PVI|PVI
PVL|PVL
PW|PW
PW PRA|PWpA
PWB|PWB
PWC|PWC
PWFL|PWFL
PWOD|PWOD
PWP|PWP
PWR|PWR
PWS|PWS
PWSC|PWSC
PWUP|PWUP
PWUPU|PWUPU
PWUPW|PWUPW
PWV|PWV
PWZ|PWZ
PX|PX
PXD|PXD
PXE|PXE
PXF|PXF
PXH|PXH
PXI|PXI
PXJ|PXJ
PXLW|PXLW
PXMD|PXMD
PXQ|PXQ
PXS|PXS
PXSAP|PXSAP
PXSAW|PXSAW
PXUS|PXUS
PY|PY
PYCR|PYCR
PYN|PYN
PYPD|PYPD
PYPE|PYPE
PYPL|PYPL
PYPS|PYPS
PYPT|PYPT
PYR|PYR
PYT|PYT
PYXS|PYXS
PYZ|PYZ
PZA|PZA
PZC|PZC
PZG|PZG
PZT|PZT
PZZA|PZZA
QABA|QABA
QAI|QAI
QARP|QARP
QAT|QAT
QBTS|QBTS
QBTS WS|QBTS.WS
QCLN|QCLN
QCLR|QCLR
QCOM|QCOM
QCON|QCON
QCRH|QCRH
QD|QD
QDEC|QDEC
QDEF|QDEF
QDEL|QDEL
QDF|QDF
QDIV|QDIV
QDPL|QDPL
QDYN|QDYN
QED|QED
QEFA|QEFA
QEMM|QEMM
QFIN|QFIN
QFTA|QFTA
QFTA U|QFTA.U
QGEN|QGEN
QGRO|QGRO
QH|QH
QID|QID
QINT|QINT
QIPT|QIPT
QIWI|QIWI
QJUN|QJUN
QLC|QLC
QLD|QLD
QLGN|QLGN
QLI|QLI
QLS|QLS
QLTA|QLTA
QLV|QLV
QLVD|QLVD
QLVE|QLVE
QLYS|QLYS
QMAR|QMAR
QMCO|QMCO
QMN|QMN
QMOM|QMOM
QNCX|QNCX
QNRX|QNRX
QNST|QNST
QOMO|QOMO
QOMOR|QOMOR
QOMOU|QOMOU
QOMOW|QOMOW
QPFF|QPFF
QPX|QPX
QQC|QQC
QQD|QQD
QQEW|QQEW
QQH|QQH
QQJG|QQJG
QQMG|QQMG
QQQ|QQQ
QQQA|QQQA
QQQE|QQQE
QQQJ|QQQJ
QQQM|QQQM
QQQN|QQQN
QQQS|QQQS
QQQX|QQQX
QQXT|QQXT
QRFT|QRFT
QRHC|QRHC
QRMI|QRMI
QRTEA|QRTEA
QRTEB|QRTEB
QRTEP|QRTEP
QRVO|QRVO
QS|QS
QSI|QSI
QSIAW|QSIAW
QSPT|QSPT
QSR|QSR
QSWN|QSWN
QTAP|QTAP
QTEC|QTEC
QTEK|QTEK
QTEKW|QTEKW
QTJA|QTJA
QTJL|QTJL
QTNT|QTNT
QTOC|QTOC
QTR|QTR
QTRX|QTRX
QTT|QTT
QTUM|QTUM
QTWO|QTWO
QUAD|QUAD
QUAL|QUAL
QUBT|QUBT
QUIK|QUIK
QULL|QULL
QUMU|QUMU
QUOT|QUOT
QURE|QURE
QUS|QUS
QVAL|QVAL
QVCC|QVCC
QVCD|QVCD
QVML|QVML
QVMM|QVMM
QVMS|QVMS
QWLD|QWLD
QYLD|QYLD
QYLG|QYLG
R|R
RA|RA
RAAS|RAAS
RAAX|RAAX
RACB|RACB
RACE|RACE
RACY|RACY
RACYU|RACYU
RACYW|RACYW
RAD|RAD
RADI|RADI
RAFE|RAFE
RAIL|RAIL
RAIN|RAIN
RAM|RAM
RAMMU|RAMMU
RAMMW|RAMMW
RAMP|RAMP
RAND|RAND
RANI|RANI
RAPT|RAPT
RARE|RARE
RATE|RATE
RAVE|RAVE
RAVI|RAVI
RAYC|RAYC
RAYD|RAYD
RAYE|RAYE
RAYS|RAYS
RBA|RBA
RBB|RBB
RBBN|RBBN
RBC|RBC
RBCAA|RBCAA
RBCN|RBCN
RBCP|RBCP
RBKB|RBKB
RBLD|RBLD
RBLX|RBLX
RBND|RBND
RBOT|RBOT
RBOT WS|RBOT.WS
RBT|RBT
RBT WS|RBT.WS
RC|RC
RC PRC|RCpC
RC PRE|RCpE
RCA|RCA
RCAC|RCAC
RCACU|RCACU
RCACW|RCACW
RCAT|RCAT
RCB|RCB
RCC|RCC
RCD|RCD
RCEL|RCEL
RCFA|RCFA
RCFA U|RCFA.U
RCFA WS|RCFA.WS
RCG|RCG
RCI|RCI
RCII|RCII
RCKT|RCKT
RCKY|RCKY
RCL|RCL
RCLF|RCLF
RCLFU|RCLFU
RCLFW|RCLFW
RCM|RCM
RCMT|RCMT
RCON|RCON
RCRT|RCRT
RCRTW|RCRTW
RCS|RCS
RCUS|RCUS
RDCM|RDCM
RDFI|RDFI
RDFN|RDFN
RDHL|RDHL
RDI|RDI
RDIB|RDIB
RDIV|RDIV
RDMX|RDMX
RDN|RDN
RDNT|RDNT
RDOG|RDOG
RDVI|RDVI
RDVT|RDVT
RDVY|RDVY
RDW|RDW
RDW WS|RDW.WS
RDWR|RDWR
RDY|RDY
RE|RE
REAL|REAL
REAX|REAX
REBN|REBN
RECS|RECS
REE|REE
REED|REED
REET|REET
REFI|REFI
REFR|REFR
REG|REG
REGL|REGL
REGN|REGN
REI|REI
REIT|REIT
REK|REK
REKR|REKR
RELI|RELI
RELIW|RELIW
RELL|RELL
RELX|RELX
RELY|RELY
REM|REM
REMG|REMG
REMX|REMX
RENE|RENE
RENEU|RENEU
RENEW|RENEW
RENN|RENN
RENT|RENT
RENW|RENW
REPL|REPL
REPX|REPX
RERE|RERE
RES|RES
RESD|RESD
RESE|RESE
RESI|RESI
RESP|RESP
RETA|RETA
RETL|RETL
RETO|RETO
REUN|REUN
REVB|REVB
REVBU|REVBU
REVBW|REVBW
REVE|REVE
REVEU|REVEU
REVEW|REVEW
REVG|REVG
REVH|REVH
REVHU|REVHU
REVHW|REVHW
REVS|REVS
REW|REW
REX|REX
REXR|REXR
REXR PRB|REXRpB
REXR PRC|REXRpC
REYN|REYN
REZ|REZ
REZI|REZI
RF|RF
RF PRB|RFpB
RF PRC|RFpC
RF PRE|RFpE
RFAC|RFAC
RFACR|RFACR
RFACU|RFACU
RFACW|RFACW
RFCI|RFCI
RFDA|RFDA
RFDI|RFDI
RFEM|RFEM
RFEU|RFEU
RFFC|RFFC
RFG|RFG
RFI|RFI
RFIL|RFIL
RFL|RFL
RFM|RFM
RFMZ|RFMZ
RFP|RFP
RFV|RFV
RGA|RGA
RGC|RGC
RGCO|RGCO
RGEN|RGEN
RGF|RGF
RGI|RGI
RGLD|RGLD
RGLS|RGLS
RGNX|RGNX
RGP|RGP
RGR|RGR
RGS|RGS
RGT|RGT
RGTI|RGTI
RGTIW|RGTIW
RH|RH
RHCB|RHCB
RHE|RHE
RHE PRA|RHEpA
RHI|RHI
RHP|RHP
RHRX|RHRX
RHS|RHS
RHTX|RHTX
RIBT|RIBT
RICK|RICK
RIDE|RIDE
RIET|RIET
RIG|RIG
RIGL|RIGL
RIGS|RIGS
RIGZ|RIGZ
RILY|RILY
RILYG|RILYG
RILYK|RILYK
RILYL|RILYL
RILYM|RILYM
RILYN|RILYN
RILYO|RILYO
RILYP|RILYP
RILYT|RILYT
RILYZ|RILYZ
RINF|RINF
RING|RING
RIO|RIO
RIOT|RIOT
RISN|RISN
RISR|RISR
RITA|RITA
RITM|RITM
RITM PRA|RITMpA
RITM PRB|RITMpB
RITM PRC|RITMpC
RITM PRD|RITMpD
RIV|RIV
RIV PRA|RIVpA
RIVN|RIVN
RJAC|RJAC
RJAC U|RJAC.U
RJAC WS|RJAC.WS
RJF|RJF
RJF PRA|RJFpA
RJF PRB|RJFpB
RKDA|RKDA
RKLB|RKLB
RKLY|RKLY
RKLY WS|RKLY.WS
RKT|RKT
RKTA|RKTA
RKTA U|RKTA.U
RKTA WS|RKTA.WS
RL|RL
RLAY|RLAY
RLGT|RLGT
RLI|RLI
RLJ|RLJ
RLJ PRA|RLJpA
RLMD|RLMD
RLTY|RLTY
RLX|RLX
RLY|RLY
RLYB|RLYB
RM|RM
RMAX|RMAX
RMBI|RMBI
RMBL|RMBL
RMBS|RMBS
RMCF|RMCF
RMD|RMD
RMED|RMED
RMGC|RMGC
RMGCU|RMGCU
RMGCW|RMGCW
RMI|RMI
RMM|RMM
RMMZ|RMMZ
RMNI|RMNI
RMPL PR|RMPLp
RMR|RMR
RMT|RMT
RMTI|RMTI
RNA|RNA
RNAZ|RNAZ
RNDM|RNDM
RNDV|RNDV
RNEM|RNEM
RNER|RNER
RNERU|RNERU
RNERW|RNERW
RNEW|RNEW
RNG|RNG
RNGR|RNGR
RNLC|RNLC
RNLX|RNLX
RNMC|RNMC
RNP|RNP
RNR|RNR
RNR PRF|RNRpF
RNR PRG|RNRpG
RNRG|RNRG
RNSC|RNSC
RNST|RNST
RNW|RNW
RNWK|RNWK
RNWWW|RNWWW
RNXT|RNXT
ROAD|ROAD
ROAM|ROAM
ROBO|ROBO
ROBT|ROBT
ROC|ROC
ROCAR|ROCAR
ROCAU|ROCAU
ROCC|ROCC
ROCG|ROCG
ROCGU|ROCGU
ROCGW|ROCGW
ROCI|ROCI
ROCK|ROCK
ROCL|ROCL
ROCLU|ROCLU
ROCLW|ROCLW
RODE|RODE
RODI|RODI
RODM|RODM
ROG|ROG
ROIC|ROIC
ROIV|ROIV
ROIVW|ROIVW
ROK|ROK
ROKT|ROKT
ROKU|ROKU
ROL|ROL
ROM|ROM
ROMO|ROMO
RONI|RONI
RONI U|RONI.U
RONI WS|RONI.WS
ROOF|ROOF
ROOT|ROOT
ROP|ROP
RORO|RORO
ROSC|ROSC
ROSE|ROSE
ROSEU|ROSEU
ROSEW|ROSEW
ROSS|ROSS
ROSS U|ROSS.U
ROSS WS|ROSS.WS
ROST|ROST
ROUS|ROUS
ROVR|ROVR
RPAR|RPAR
RPAY|RPAY
RPD|RPD
RPG|RPG
RPHM|RPHM
RPHS|RPHS
RPID|RPID
RPM|RPM
RPRX|RPRX
RPT|RPT
RPT PRD|RPTpD
RPTX|RPTX
RPV|RPV
RQI|RQI
RRAC|RRAC
RRAC U|RRAC.U
RRAC WS|RRAC.WS
RRBI|RRBI
RRC|RRC
RRGB|RRGB
RRH|RRH
RRR|RRR
RRX|RRX
RS|RS
RSEE|RSEE
RSF|RSF
RSG|RSG
RSI|RSI
RSKD|RSKD
RSLS|RSLS
RSP|RSP
RSPE|RSPE
RSPY|RSPY
RSSS|RSSS
RSVR|RSVR
RSVRW|RSVRW
RSX|RSX
RSXJ|RSXJ
RTAI|RTAI
RTH|RTH
RTL|RTL
RTLPO|RTLPO
RTLPP|RTLPP
RTM|RTM
RTO|RTO
RTX|RTX
RTYD|RTYD
RUBY|RUBY
RUFF|RUFF
RULE|RULE
RUM|RUM
RUMBW|RUMBW
RUN|RUN
RUSHA|RUSHA
RUSHB|RUSHB
RUTH|RUTH
RVLP|RVLP
RVLV|RVLV
RVMD|RVMD
RVNC|RVNC
RVNU|RVNU
RVP|RVP
RVPH|RVPH
RVPHW|RVPHW
RVRB|RVRB
RVSB|RVSB
RVSN|RVSN
RVSNW|RVSNW
RVT|RVT
RVYL|RVYL
RWAY|RWAY
RWAYL|RWAYL
RWJ|RWJ
RWK|RWK
RWL|RWL
RWLK|RWLK
RWM|RWM
RWO|RWO
RWOD|RWOD
RWODR|RWODR
RWODU|RWODU
RWODW|RWODW
RWR|RWR
RWT|RWT
RWX|RWX
RXD|RXD
RXDX|RXDX
RXI|RXI
RXL|RXL
RXO|RXO
RXRA|RXRA
RXRAU|RXRAU
RXRAW|RXRAW
RXRX|RXRX
RXST|RXST
RXT|RXT
RY|RY
RY PRT|RYpT
RYAAY|RYAAY
RYAM|RYAM
RYAN|RYAN
RYE|RYE
RYF|RYF
RYH|RYH
RYI|RYI
RYJ|RYJ
RYLD|RYLD
RYLG|RYLG
RYN|RYN
RYT|RYT
RYTM|RYTM
RYU|RYU
RZA|RZA
RZB|RZB
RZC|RZC
RZG|RZG
RZLT|RZLT
RZV|RZV
S|S
SA|SA
SAA|SAA
SABR|SABR
SABRP|SABRP
SABS|SABS
SABSW|SABSW
SACC|SACC
SACH|SACH
SACH PRA|SACHpA
SAEF|SAEF
SAFE|SAFE
SAFT|SAFT
SAGA|SAGA
SAGAR|SAGAR
SAGAU|SAGAU
SAGE|SAGE
SAGP|SAGP
SAH|SAH
SAI|SAI
SAIA|SAIA
SAIC|SAIC
SAITW|SAITW
SAJ|SAJ
SAL|SAL
SALM|SALM
SAM|SAM
SAMA|SAMA
SAMAU|SAMAU
SAMAW|SAMAW
SAMG|SAMG
SAMT|SAMT
SAN|SAN
SANA|SANA
SAND|SAND
SANG|SANG
SANM|SANM
SANW|SANW
SAP|SAP
SAR|SAR
SARK|SARK
SASI|SASI
SASR|SASR
SAT|SAT
SATL|SATL
SATLW|SATLW
SATO|SATO
SATS|SATS
SATX|SATX
SATX WSA|SATX.WS.A
SAVA|SAVA
SAVE|SAVE
SAVN|SAVN
SB|SB
SB PRC|SBpC
SB PRD|SBpD
SBAC|SBAC
SBB|SBB
SBBA|SBBA
SBCF|SBCF
SBET|SBET
SBEV|SBEV
SBEV WS|SBEV.WS
SBFG|SBFG
SBFM|SBFM
SBFMW|SBFMW
SBGI|SBGI
SBH|SBH
SBI|SBI
SBIG|SBIG
SBIGW|SBIGW
SBIO|SBIO
SBLK|SBLK
SBND|SBND
SBNY|SBNY
SBNYP|SBNYP
SBOW|SBOW
SBR|SBR
SBRA|SBRA
SBS|SBS
SBSI|SBSI
SBSW|SBSW
SBT|SBT
SBUG|SBUG
SBUX|SBUX
SCAQ|SCAQ
SCAQU|SCAQU
SCAQW|SCAQW
SCC|SCC
SCCB|SCCB
SCCC|SCCC
SCCD|SCCD
SCCE|SCCE
SCCF|SCCF
SCCG|SCCG
SCCO|SCCO
SCD|SCD
SCDL|SCDL
SCE PRG|SCEpG
SCE PRH|SCEpH
SCE PRJ|SCEpJ
SCE PRK|SCEpK
SCE PRL|SCEpL
SCHA|SCHA
SCHB|SCHB
SCHC|SCHC
SCHD|SCHD
SCHE|SCHE
SCHF|SCHF
SCHG|SCHG
SCHH|SCHH
SCHI|SCHI
SCHJ|SCHJ
SCHK|SCHK
SCHL|SCHL
SCHM|SCHM
SCHN|SCHN
SCHO|SCHO
SCHP|SCHP
SCHQ|SCHQ
SCHR|SCHR
SCHV|SCHV
SCHW|SCHW
SCHW PRD|SCHWpD
SCHW PRJ|SCHWpJ
SCHX|SCHX
SCHY|SCHY
SCHZ|SCHZ
SCI|SCI
SCJ|SCJ
SCKT|SCKT
SCL|SCL
SCLE|SCLE
SCLEU|SCLEU
SCLEW|SCLEW
SCLX|SCLX
SCLXW|SCLXW
SCM|SCM
SCMA|SCMA
SCMAU|SCMAU
SCMAW|SCMAW
SCMB|SCMB
SCO|SCO
SCOA|SCOA
SCOAU|SCOAU
SCOAW|SCOAW
SCOB|SCOB
SCOBU|SCOBU
SCOBW|SCOBW
SCOR|SCOR
SCPH|SCPH
SCPL|SCPL
SCPS|SCPS
SCRD|SCRD
SCRM|SCRM
SCRMU|SCRMU
SCRMW|SCRMW
SCS|SCS
SCSC|SCSC
SCTL|SCTL
SCU|SCU
SCUA|SCUA
SCUA U|SCUA.U
SCUA WS|SCUA.WS
SCVL|SCVL
SCWO|SCWO
SCWX|SCWX
SCX|SCX
SCYX|SCYX
SCZ|SCZ
SD|SD
SDAC|SDAC
SDACU|SDACU
SDACW|SDACW
SDC|SDC
SDCI|SDCI
SDD|SDD
SDEF|SDEF
SDEI|SDEI
SDEM|SDEM
SDG|SDG
SDGA|SDGA
SDGR|SDGR
SDGS|SDGS
SDHY|SDHY
SDIG|SDIG
SDIV|SDIV
SDOG|SDOG
SDOW|SDOW
SDP|SDP
SDPI|SDPI
SDRL|SDRL
SDS|SDS
SDSI|SDSI
SDVY|SDVY
SDY|SDY
SE|SE
SEA|SEA
SEAC|SEAC
SEAL PRA|SEALpA
SEAL PRB|SEALpB
SEAS|SEAS
SEAT|SEAT
SEATW|SEATW
SEB|SEB
SECO|SECO
SECT|SECT
SEDA|SEDA
SEDA U|SEDA.U
SEDA WS|SEDA.WS
SEDG|SEDG
SEE|SEE
SEED|SEED
SEEL|SEEL
SEER|SEER
SEF|SEF
SEIC|SEIC
SEIM|SEIM
SEIQ|SEIQ
SEIV|SEIV
SEIX|SEIX
SELB|SELB
SELF|SELF
SELV|SELV
SEM|SEM
SEMI|SEMI
SEMR|SEMR
SENEA|SENEA
SENEB|SENEB
SENS|SENS
SENT|SENT
SEPZ|SEPZ
SERA|SERA
SES|SES
SES WS|SES.WS
SESG|SESG
SESN|SESN
SEV|SEV
SEVN|SEVN
SF|SF
SF PRB|SFpB
SF PRC|SFpC
SF PRD|SFpD
SFB|SFB
SFBC|SFBC
SFBS|SFBS
SFE|SFE
SFET|SFET
SFIG|SFIG
SFIX|SFIX
SFL|SFL
SFLR|SFLR
SFM|SFM
SFNC|SFNC
SFR|SFR
SFRWW|SFRWW
SFST|SFST
SFT|SFT
SFY|SFY
SFYF|SFYF
SFYX|SFYX
SG|SG
SGA|SGA
SGBX|SGBX
SGC|SGC
SGDJ|SGDJ
SGDM|SGDM
SGEN|SGEN
SGFY|SGFY
SGG|SGG
SGH|SGH
SGHC|SGHC
SGHC WS|SGHC.WS
SGHL|SGHL
SGHLU|SGHLU
SGHLW|SGHLW
SGHT|SGHT
SGII|SGII
SGIIU|SGIIU
SGIIW|SGIIW
SGLY|SGLY
SGMA|SGMA
SGML|SGML
SGMO|SGMO
SGOL|SGOL
SGOV|SGOV
SGRP|SGRP
SGRY|SGRY
SGTX|SGTX
SGU|SGU
SH|SH
SHAC|SHAC
SHACU|SHACU
SHACW|SHACW
SHAG|SHAG
SHAK|SHAK
SHAP|SHAP
SHAP U|SHAP.U
SHAP WS|SHAP.WS
SHBI|SHBI
SHC|SHC
SHCA|SHCA
SHCAU|SHCAU
SHCAW|SHCAW
SHCR|SHCR
SHCRW|SHCRW
SHDG|SHDG
SHE|SHE
SHEL|SHEL
SHEN|SHEN
SHFS|SHFS
SHFSW|SHFSW
SHG|SHG
SHIP|SHIP
SHLS|SHLS
SHM|SHM
SHO|SHO
SHO PRH|SHOpH
SHO PRI|SHOpI
SHOC|SHOC
SHOO|SHOO
SHOP|SHOP
SHPH|SHPH
SHPP|SHPP
SHPW|SHPW
SHPW WS|SHPW.WS
SHQA|SHQA
SHQAU|SHQAU
SHQAW|SHQAW
SHUA|SHUA
SHUAU|SHUAU
SHUAW|SHUAW
SHUS|SHUS
SHV|SHV
SHW|SHW
SHY|SHY
SHYD|SHYD
SHYF|SHYF
SHYG|SHYG
SHYL|SHYL
SI|SI
SI PRA|SIpA
SIBN|SIBN
SID|SID
SIDU|SIDU
SIEB|SIEB
SIEN|SIEN
SIER|SIER
SIERU|SIERU
SIERW|SIERW
SIF|SIF
SIFI|SIFI
SIFY|SIFY
SIG|SIG
SIGA|SIGA
SIGI|SIGI
SIGIP|SIGIP
SIHY|SIHY
SII|SII
SIJ|SIJ
SIL|SIL
SILC|SILC
SILJ|SILJ
SILK|SILK
SILO|SILO
SILV|SILV
SILX|SILX
SIM|SIM
SIMO|SIMO
SIMS|SIMS
SINT|SINT
SIO|SIO
SIOX|SIOX
SIRE|SIRE
SIRI|SIRI
SISI|SISI
SITC|SITC
SITC PRA|SITCpA
SITE|SITE
SITM|SITM
SIVB|SIVB
SIVBP|SIVBP
SIVR|SIVR
SIX|SIX
SIXA|SIXA
SIXH|SIXH
SIXJ|SIXJ
SIXL|SIXL
SIXO|SIXO
SIXS|SIXS
SIZE|SIZE
SJ|SJ
SJB|SJB
SJI|SJI
SJIJ|SJIJ
SJIV|SJIV
SJM|SJM
SJNK|SJNK
SJR|SJR
SJT|SJT
SJW|SJW
SKE|SKE
SKF|SKF
SKGR|SKGR
SKGRU|SKGRU
SKGRW|SKGRW
SKIL|SKIL
SKIL WS|SKIL.WS
SKIN|SKIN
SKLZ|SKLZ
SKM|SKM
SKOR|SKOR
SKT|SKT
SKX|SKX
SKY|SKY
SKYA|SKYA
SKYAU|SKYAU
SKYAW|SKYAW
SKYH|SKYH
SKYH WS|SKYH.WS
SKYT|SKYT
SKYU|SKYU
SKYW|SKYW
SKYX|SKYX
SKYY|SKYY
SLAB|SLAB
SLAC|SLAC
SLAC U|SLAC.U
SLAC WS|SLAC.WS
SLAM|SLAM
SLAMU|SLAMU
SLAMW|SLAMW
SLB|SLB
SLCA|SLCA
SLDB|SLDB
SLDP|SLDP
SLDPW|SLDPW
SLF|SLF
SLG|SLG
SLG PRI|SLGpI
SLGC|SLGC
SLGCW|SLGCW
SLGG|SLGG
SLGL|SLGL
SLGN|SLGN
SLI|SLI
SLM|SLM
SLMBP|SLMBP
SLN|SLN
SLNA|SLNA
SLNAW|SLNAW
SLNG|SLNG
SLNH|SLNH
SLNHP|SLNHP
SLNO|SLNO
SLP|SLP
SLQD|SLQD
SLQT|SLQT
SLRC|SLRC
SLRX|SLRX
SLS|SLS
SLV|SLV
SLVM|SLVM
SLVO|SLVO
SLVP|SLVP
SLVR|SLVR
SLVRU|SLVRU
SLVRW|SLVRW
SLX|SLX
SLY|SLY
SLYG|SLYG
SLYV|SLYV
SM|SM
SMAP|SMAP
SMAPU|SMAPU
SMAPW|SMAPW
SMAR|SMAR
SMB|SMB
SMBC|SMBC
SMBK|SMBK
SMCI|SMCI
SMCP|SMCP
SMDD|SMDD
SMDV|SMDV
SMDY|SMDY
SMFG|SMFG
SMFL|SMFL
SMFR|SMFR
SMFRW|SMFRW
SMG|SMG
SMH|SMH
SMHB|SMHB
SMHI|SMHI
SMI|SMI
SMID|SMID
SMIG|SMIG
SMIH|SMIH
SMIHU|SMIHU
SMIHW|SMIHW
SMIN|SMIN
SMIT|SMIT
SMLE|SMLE
SMLF|SMLF
SMLP|SMLP
SMLR|SMLR
SMLV|SMLV
SMMD|SMMD
SMMF|SMMF
SMMT|SMMT
SMMU|SMMU
SMMV|SMMV
SMN|SMN
SMOG|SMOG
SMOT|SMOT
SMP|SMP
SMPL|SMPL
SMR|SMR
SMR WS|SMR.WS
SMRT|SMRT
SMSI|SMSI
SMTC|SMTC
SMTI|SMTI
SMWB|SMWB
SNA|SNA
SNAL|SNAL
SNAP|SNAP
SNAX|SNAX
SNAXW|SNAXW
SNBR|SNBR
SNCE|SNCE
SNCR|SNCR
SNCRL|SNCRL
SNCY|SNCY
SND|SND
SNDA|SNDA
SNDL|SNDL
SNDR|SNDR
SNDX|SNDX
SNES|SNES
SNEX|SNEX
SNFCA|SNFCA
SNGX|SNGX
SNLN|SNLN
SNMP|SNMP
SNN|SNN
SNOA|SNOA
SNOW|SNOW
SNPD|SNPD
SNPE|SNPE
SNPG|SNPG
SNPO|SNPO
SNPS|SNPS
SNPV|SNPV
SNPX|SNPX
SNRH|SNRH
SNRHU|SNRHU
SNRHW|SNRHW
SNSE|SNSE
SNSR|SNSR
SNT|SNT
SNTG|SNTG
SNTI|SNTI
SNV|SNV
SNV PRD|SNVpD
SNV PRE|SNVpE
SNX|SNX
SNY|SNY
SO|SO
SOBR|SOBR
SOCL|SOCL
SOFI|SOFI
SOFO|SOFO
SOGU|SOGU
SOHO|SOHO
SOHOB|SOHOB
SOHON|SOHON
SOHOO|SOHOO
SOHU|SOHU
SOI|SOI
SOJC|SOJC
SOJD|SOJD
SOJE|SOJE
SOL|SOL
SOLO|SOLO
SOLOW|SOLOW
SOLR|SOLR
SON|SON
SOND|SOND
SONDW|SONDW
SONM|SONM
SONN|SONN
SONO|SONO
SONX|SONX
SONY|SONY
SOPA|SOPA
SOPH|SOPH
SOR|SOR
SOS|SOS
SOTK|SOTK
SOUN|SOUN
SOUNW|SOUNW
SOVO|SOVO
SOXL|SOXL
SOXQ|SOXQ
SOXS|SOXS
SOXX|SOXX
SOYB|SOYB
SP|SP
SPAB|SPAB
SPAX|SPAX
SPB|SPB
SPBC|SPBC
SPBO|SPBO
SPC|SPC
SPCB|SPCB
SPCE|SPCE
SPCM|SPCM
SPCMU|SPCMU
SPCMW|SPCMW
SPCX|SPCX
SPCZ|SPCZ
SPD|SPD
SPDN|SPDN
SPDV|SPDV
SPDW|SPDW
SPE|SPE
SPE PRC|SPEpC
SPEM|SPEM
SPEU|SPEU
SPFF|SPFF
SPFI|SPFI
SPG|SPG
SPG PRJ|SPGpJ
SPGI|SPGI
SPGM|SPGM
SPGP|SPGP
SPGS|SPGS
SPGS U|SPGS.U
SPH|SPH
SPHB|SPHB
SPHD|SPHD
SPHQ|SPHQ
SPHY|SPHY
SPI|SPI
SPIB|SPIB
SPIP|SPIP
SPIR|SPIR
SPIR WS|SPIR.WS
SPK|SPK
SPKAR|SPKAR
SPKAU|SPKAU
SPKB|SPKB
SPKBU|SPKBU
SPKBW|SPKBW
SPKX|SPKX
SPKY|SPKY
SPLB|SPLB
SPLG|SPLG
SPLK|SPLK
SPLP|SPLP
SPLP PRA|SPLPpA
SPLV|SPLV
SPMB|SPMB
SPMD|SPMD
SPMO|SPMO
SPMV|SPMV
SPNE|SPNE
SPNS|SPNS
SPNT|SPNT
SPNT PRB|SPNTpB
SPOK|SPOK
SPOT|SPOT
SPPI|SPPI
SPPP|SPPP
SPR|SPR
SPRB|SPRB
SPRC|SPRC
SPRE|SPRE
SPRO|SPRO
SPRU|SPRU
SPRX|SPRX
SPRY|SPRY
SPSB|SPSB
SPSC|SPSC
SPSK|SPSK
SPSM|SPSM
SPT|SPT
SPTI|SPTI
SPTK|SPTK
SPTKU|SPTKU
SPTKW|SPTKW
SPTL|SPTL
SPTM|SPTM
SPTN|SPTN
SPTS|SPTS
SPUC|SPUC
SPUS|SPUS
SPUU|SPUU
SPVM|SPVM
SPVU|SPVU
SPWH|SPWH
SPWR|SPWR
SPXB|SPXB
SPXC|SPXC
SPXE|SPXE
SPXL|SPXL
SPXN|SPXN
SPXS|SPXS
SPXT|SPXT
SPXU|SPXU
SPXV|SPXV
SPXX|SPXX
SPY|SPY
SPYC|SPYC
SPYD|SPYD
SPYG|SPYG
SPYI|SPYI
SPYV|SPYV
SPYX|SPYX
SQ|SQ
SQEW|SQEW
SQFT|SQFT
SQFTP|SQFTP
SQFTW|SQFTW
SQL|SQL
SQLLW|SQLLW
SQLV|SQLV
SQM|SQM
SQNS|SQNS
SQQQ|SQQQ
SQSP|SQSP
SQZ|SQZ
SR|SR
SR PRA|SRpA
SRAD|SRAD
SRAX|SRAX
SRC|SRC
SRC PRA|SRCpA
SRCE|SRCE
SRCL|SRCL
SRDX|SRDX
SRE|SRE
SREA|SREA
SRET|SRET
SRG|SRG
SRG PRA|SRGpA
SRGA|SRGA
SRHQ|SRHQ
SRI|SRI
SRL|SRL
SRLN|SRLN
SRNE|SRNE
SRPT|SRPT
SRRK|SRRK
SRS|SRS
SRT|SRT
SRTS|SRTS
SRTY|SRTY
SRV|SRV
SRVR|SRVR
SRZN|SRZN
SRZNW|SRZNW
SSAA|SSAA
SSAAU|SSAAU
SSAAW|SSAAW
SSB|SSB
SSBI|SSBI
SSBK|SSBK
SSD|SSD
SSFI|SSFI
SSG|SSG
SSIC|SSIC
SSKN|SSKN
SSL|SSL
SSLY|SSLY
SSNC|SSNC
SSNT|SSNT
SSO|SSO
SSP|SSP
SSPX|SSPX
SSPY|SSPY
SSRM|SSRM
SSSS|SSSS
SSSSL|SSSSL
SST|SST
SST WS|SST.WS
SSTI|SSTI
SSTK|SSTK
SSU|SSU
SSU WS|SSU.WS
SSUS|SSUS
SSXU|SSXU
SSY|SSY
SSYS|SSYS
ST|ST
STAA|STAA
STAB|STAB
STAF|STAF
STAG|STAG
STAR|STAR
STAR PRD|STARpD
STAR PRG|STARpG
STAR PRI|STARpI
STBA|STBA
STBX|STBX
STC|STC
STCE|STCE
STCN|STCN
STE|STE
STEL|STEL
STEM|STEM
STEP|STEP
STER|STER
STET|STET
STET U|STET.U
STET WS|STET.WS
STEW|STEW
STG|STG
STGF|STGF
STGW|STGW
STIM|STIM
STIP|STIP
STIX|STIX
STIXW|STIXW
STK|STK
STKH|STKH
STKL|STKL
STKS|STKS
STLA|STLA
STLD|STLD
STLG|STLG
STLV|STLV
STM|STM
STN|STN
STNC|STNC
STNE|STNE
STNG|STNG
STOK|STOK
STOR|STOR
STOT|STOT
STPZ|STPZ
STR|STR
STR WS|STR.WS
STRA|STRA
STRC|STRC
STRCW|STRCW
STRE|STRE
STRE U|STRE.U
STRE WS|STRE.WS
STRL|STRL
STRM|STRM
STRN|STRN
STRNW|STRNW
STRO|STRO
STRR|STRR
STRRP|STRRP
STRS|STRS
STRT|STRT
STRV|STRV
STRY|STRY
STRY WS|STRY.WS
STSA|STSA
STSS|STSS
STSSW|STSSW
STT|STT
STT PRD|STTpD
STT PRG|STTpG
STTK|STTK
STVN|STVN
STWD|STWD
STX|STX
STXD|STXD
STXG|STXG
STXK|STXK
STXS|STXS
STXV|STXV
STZ|STZ
SU|SU
SUAC|SUAC
SUAC U|SUAC.U
SUAC WS|SUAC.WS
SUB|SUB
SUBS|SUBS
SUI|SUI
SUM|SUM
SUMO|SUMO
SUN|SUN
SUNL|SUNL
SUNL WS|SUNL.WS
SUNW|SUNW
SUP|SUP
SUPL|SUPL
SUPN|SUPN
SUPV|SUPV
SURE|SURE
SURF|SURF
SURG|SURG
SURGW|SURGW
SUSA|SUSA
SUSB|SUSB
SUSC|SUSC
SUSL|SUSL
SUZ|SUZ
SVA|SVA
SVAL|SVAL
SVC|SVC
SVFA|SVFA
SVFAU|SVFAU
SVFAW|SVFAW
SVFB|SVFB
SVFD|SVFD
SVII|SVII
SVIIR|SVIIR
SVIIU|SVIIU
SVIIW|SVIIW
SVIX|SVIX
SVM|SVM
SVNA|SVNA
SVNAU|SVNAU
SVNAW|SVNAW
SVOL|SVOL
SVRA|SVRA
SVRE|SVRE
SVREW|SVREW
SVT|SVT
SVVC|SVVC
SVXY|SVXY
SWAN|SWAN
SWAR|SWAR
SWAV|SWAV
SWBI|SWBI
SWCH|SWCH
SWEB|SWEB
SWI|SWI
SWIM|SWIM
SWIR|SWIR
SWK|SWK
SWKH|SWKH
SWKS|SWKS
SWN|SWN
SWSS|SWSS
SWSSU|SWSSU
SWSSW|SWSSW
SWTX|SWTX
SWVL|SWVL
SWVLW|SWVLW
SWX|SWX
SWZ|SWZ
SXC|SXC
SXI|SXI
SXQG|SXQG
SXT|SXT
SXTC|SXTC
SXUS|SXUS
SY|SY
SYBT|SYBT
SYBX|SYBX
SYF|SYF
SYF PRA|SYFpA
SYII|SYII
SYK|SYK
SYLD|SYLD
SYM|SYM
SYNA|SYNA
SYNB|SYNB
SYNH|SYNH
SYPR|SYPR
SYRS|SYRS
SYTA|SYTA
SYTAW|SYTAW
SYUS|SYUS
SYY|SYY
SZK|SZK
SZNE|SZNE
SZZL|SZZL
SZZLU|SZZLU
SZZLW|SZZLW
T|T
T PRA|TpA
T PRC|TpC
TA|TA
TAC|TAC
TACK|TACK
TACT|TACT
TAFI|TAFI
TAGG|TAGG
TAGS|TAGS
TAIL|TAIL
TAIT|TAIT
TAK|TAK
TAL|TAL
TALK|TALK
TALKW|TALKW
TALO|TALO
TALS|TALS
TAN|TAN
TANH|TANH
TANNI|TANNI
TANNL|TANNL
TANNZ|TANNZ
TAOP|TAOP
TAP|TAP
TAP A|TAP.A
TARA|TARA
TARK|TARK
TARO|TARO
TARS|TARS
TASK|TASK
TAST|TAST
TATT|TATT
TAXF|TAXF
TAYD|TAYD
TBB|TBB
TBBK|TBBK
TBC|TBC
TBCP|TBCP
TBCPU|TBCPU
TBCPW|TBCPW
TBF|TBF
TBI|TBI
TBIL|TBIL
TBJL|TBJL
TBLA|TBLA
TBLAW|TBLAW
TBLD|TBLD
TBLT|TBLT
TBLTW|TBLTW
TBNK|TBNK
TBPH|TBPH
TBSA|TBSA
TBSAU|TBSAU
TBSAW|TBSAW
TBT|TBT
TBUX|TBUX
TBX|TBX
TC|TC
TCBC|TCBC
TCBI|TCBI
TCBIO|TCBIO
TCBK|TCBK
TCBP|TCBP
TCBPW|TCBPW
TCBS|TCBS
TCBX|TCBX
TCDA|TCDA
TCFC|TCFC
TCHI|TCHI
TCHP|TCHP
TCI|TCI
TCMD|TCMD
TCN|TCN
TCOA|TCOA
TCOA U|TCOA.U
TCOA WS|TCOA.WS
TCOM|TCOM
TCON|TCON
TCPC|TCPC
TCRR|TCRR
TCRT|TCRT
TCRX|TCRX
TCS|TCS
TCVA|TCVA
TCX|TCX
TD|TD
TDC|TDC
TDCX|TDCX
TDF|TDF
TDG|TDG
TDIV|TDIV
TDOC|TDOC
TDS|TDS
TDS PRU|TDSpU
TDS PRV|TDSpV
TDSA|TDSA
TDSB|TDSB
TDSC|TDSC
TDSD|TDSD
TDSE|TDSE
TDTF|TDTF
TDTT|TDTT
TDUP|TDUP
TDV|TDV
TDVG|TDVG
TDW|TDW
TDW WS|TDW.WS
TDW WSA|TDW.WS.A
TDW WSB|TDW.WS.B
TDY|TDY
TEAF|TEAF
TEAM|TEAM
TECB|TECB
TECH|TECH
TECK|TECK
TECL|TECL
TECS|TECS
TECTP|TECTP
TEDU|TEDU
TEF|TEF
TEI|TEI
TEL|TEL
TELA|TELA
TELL|TELL
TELZ|TELZ
TEMP|TEMP
TENB|TENB
TENKU|TENKU
TENX|TENX
TEO|TEO
TEQI|TEQI
TER|TER
TERN|TERN
TESS|TESS
TETC|TETC
TETCU|TETCU
TETCW|TETCW
TETE|TETE
TETEU|TETEU
TETEW|TETEW
TEVA|TEVA
TEX|TEX
TFC|TFC
TFC PRI|TFCpI
TFC PRO|TFCpO
TFC PRR|TFCpR
TFFP|TFFP
TFI|TFI
TFII|TFII
TFIN|TFIN
TFINP|TFINP
TFJL|TFJL
TFLO|TFLO
TFLR|TFLR
TFPM|TFPM
TFSA|TFSA
TFSL|TFSL
TFX|TFX
TG|TG
TGAA|TGAA
TGAAU|TGAAU
TGAAW|TGAAW
TGAN|TGAN
TGB|TGB
TGH|TGH
TGH PRA|TGHpA
TGH PRB|TGHpB
TGI|TGI
TGIF|TGIF
TGL|TGL
TGLS|TGLS
TGN|TGN
TGNA|TGNA
TGR|TGR
TGR U|TGR.U
TGR WS|TGR.WS
TGRW|TGRW
TGS|TGS
TGT|TGT
TGTX|TGTX
TGVC|TGVC
TGVCU|TGVCU
TGVCW|TGVCW
TH|TH
THAC|THAC
THACU|THACU
THACW|THACW
THC|THC
THCH|THCH
THCHW|THCHW
THCP|THCP
THCPU|THCPU
THCPW|THCPW
THCX|THCX
THD|THD
THFF|THFF
THG|THG
THLV|THLV
THM|THM
THMO|THMO
THNQ|THNQ
THO|THO
THQ|THQ
THR|THR
THRD|THRD
THRM|THRM
THRN|THRN
THRX|THRX
THRY|THRY
THS|THS
THTX|THTX
THW|THW
THWWW|THWWW
THY|THY
THYF|THYF
TIG|TIG
TIGO|TIGO
TIGR|TIGR
TIL|TIL
TILE|TILE
TILL|TILL
TILT|TILT
TIMB|TIMB
TIME|TIME
TINT|TINT
TINY|TINY
TIOA|TIOA
TIOAU|TIOAU
TIOAW|TIOAW
TIP|TIP
TIPD|TIPD
TIPL|TIPL
TIPT|TIPT
TIPX|TIPX
TIPZ|TIPZ
TIRX|TIRX
TISI|TISI
TITN|TITN
TIVC|TIVC
TIXT|TIXT
TJX|TJX
TK|TK
TKAT|TKAT
TKC|TKC
TKLF|TKLF
TKNO|TKNO
TKR|TKR
TLF|TLF
TLGA|TLGA
TLGA U|TLGA.U
TLGY|TLGY
TLGYU|TLGYU
TLGYW|TLGYW
TLH|TLH
TLIS|TLIS
TLK|TLK
TLRY|TLRY
TLS|TLS
TLSA|TLSA
TLT|TLT
TLTD|TLTD
TLTE|TLTE
TLTW|TLTW
TLYS|TLYS
TM|TM
TMAT|TMAT
TMBR|TMBR
TMC|TMC
TMCI|TMCI
TMCWW|TMCWW
TMDI|TMDI
TMDV|TMDV
TMDX|TMDX
TME|TME
TMF|TMF
TMFC|TMFC
TMFE|TMFE
TMFG|TMFG
TMFM|TMFM
TMFS|TMFS
TMFX|TMFX
TMHC|TMHC
TMKR|TMKR
TMKRU|TMKRU
TMKRW|TMKRW
TMO|TMO
TMP|TMP
TMPO|TMPO
TMPOW|TMPOW
TMQ|TMQ
TMST|TMST
TMUS|TMUS
TMV|TMV
TNA|TNA
TNC|TNC
TNDM|TNDM
TNET|TNET
TNGX|TNGX
TNK|TNK
TNL|TNL
TNON|TNON
TNP|TNP
TNP PRD|TNPpD
TNP PRE|TNPpE
TNP PRF|TNPpF
TNXP|TNXP
TNYA|TNYA
TOAC|TOAC
TOACU|TOACU
TOACW|TOACW
TOI|TOI
TOIIW|TOIIW
TOK|TOK
TOKE|TOKE
TOL|TOL
TOLZ|TOLZ
TOMZ|TOMZ
TOP|TOP
TOPS|TOPS
TOST|TOST
TOTL|TOTL
TOTR|TOTR
TOUR|TOUR
TOVX|TOVX
TOWN|TOWN
TPB|TPB
TPBA|TPBA
TPBAU|TPBAU
TPBAW|TPBAW
TPC|TPC
TPG|TPG
TPH|TPH
TPHD|TPHD
TPHE|TPHE
TPHS|TPHS
TPIC|TPIC
TPIF|TPIF
TPL|TPL
TPLC|TPLC
TPLE|TPLE
TPOR|TPOR
TPR|TPR
TPSC|TPSC
TPST|TPST
TPTA|TPTA
TPVG|TPVG
TPX|TPX
TPYP|TPYP
TPZ|TPZ
TQQQ|TQQQ
TR|TR
TRAQ|TRAQ
TRAQ U|TRAQ.U
TRAQ WS|TRAQ.WS
TRC|TRC
TRCA|TRCA
TRCA U|TRCA.U
TRCA WS|TRCA.WS
TRDA|TRDA
TREE|TREE
TREX|TREX
TRFK|TRFK
TRFM|TRFM
TRGP|TRGP
TRHC|TRHC
TRI|TRI
TRIB|TRIB
TRIN|TRIN
TRINL|TRINL
TRIP|TRIP
TRIS|TRIS
TRIS U|TRIS.U
TRIS WS|TRIS.WS
TRKA|TRKA
TRKAW|TRKAW
TRMB|TRMB
TRMD|TRMD
TRMK|TRMK
TRMR|TRMR
TRN|TRN
TRND|TRND
TRNO|TRNO
TRNS|TRNS
TRON|TRON
TRONU|TRONU
TRONW|TRONW
TROO|TROO
TROW|TROW
TROX|TROX
TRP|TRP
TRPL|TRPL
TRQ|TRQ
TRS|TRS
TRST|TRST
TRT|TRT
TRTL|TRTL
TRTL U|TRTL.U
TRTL WS|TRTL.WS
TRTN|TRTN
TRTN PRA|TRTNpA
TRTN PRB|TRTNpB
TRTN PRC|TRTNpC
TRTN PRD|TRTNpD
TRTN PRE|TRTNpE
TRTX|TRTX
TRTX PRC|TRTXpC
TRTY|TRTY
TRU|TRU
TRUE|TRUE
TRUP|TRUP
TRV|TRV
TRVG|TRVG
TRVI|TRVI
TRVN|TRVN
TRX|TRX
TS|TS
TSAT|TSAT
TSBK|TSBK
TSCO|TSCO
TSE|TSE
TSEM|TSEM
TSHA|TSHA
TSI|TSI
TSJA|TSJA
TSL|TSL
TSLA|TSLA
TSLH|TSLH
TSLI|TSLI
TSLL|TSLL
TSLQ|TSLQ
TSLS|TSLS
TSLX|TSLX
TSLY|TSLY
TSM|TSM
TSME|TSME
TSN|TSN
TSOC|TSOC
TSP|TSP
TSPA|TSPA
TSPQ|TSPQ
TSPQ U|TSPQ.U
TSQ|TSQ
TSRI|TSRI
TSVT|TSVT
TT|TT
TTAC|TTAC
TTAI|TTAI
TTC|TTC
TTCF|TTCF
TTD|TTD
TTE|TTE
TTEC|TTEC
TTEK|TTEK
TTGT|TTGT
TTI|TTI
TTM|TTM
TTMI|TTMI
TTNP|TTNP
TTOO|TTOO
TTP|TTP
TTSH|TTSH
TTT|TTT
TTWO|TTWO
TU|TU
TUA|TUA
TUEM|TUEM
TUG|TUG
TUGN|TUGN
TUP|TUP
TUR|TUR
TURN|TURN
TUSI|TUSI
TUSK|TUSK
TUYA|TUYA
TV|TV
TVC|TVC
TVE|TVE
TVTX|TVTX
TW|TW
TWCB|TWCB
TWCBU|TWCBU
TWCBW|TWCBW
TWEB|TWEB
TWI|TWI
TWIN|TWIN
TWIO|TWIO
TWKS|TWKS
TWLO|TWLO
TWLV|TWLV
TWLVU|TWLVU
TWLVW|TWLVW
TWM|TWM
TWN|TWN
TWND|TWND
TWND U|TWND.U
TWND WS|TWND.WS
TWNI|TWNI
TWNI U|TWNI.U
TWNK|TWNK
TWO|TWO
TWO PRA|TWOpA
TWO PRB|TWOpB
TWO PRC|TWOpC
TWOA|TWOA
TWOU|TWOU
TWST|TWST
TX|TX
TXG|TXG
TXMD|TXMD
TXN|TXN
TXRH|TXRH
TXT|TXT
TY|TY
TY PR|TYp
TYA|TYA
TYD|TYD
TYDE|TYDE
TYG|TYG
TYL|TYL
TYLG|TYLG
TYNE|TYNE
TYO|TYO
TYRA|TYRA
TZA|TZA
TZOO|TZOO
TZPS|TZPS
TZPSU|TZPSU
TZPSW|TZPSW
U|U
UA|UA
UAA|UAA
UAE|UAE
UAL|UAL
UAMY|UAMY
UAN|UAN
UAPR|UAPR
UAUG|UAUG
UAV|UAV
UAVS|UAVS
UBA|UBA
UBCB|UBCB
UBCP|UBCP
UBER|UBER
UBFO|UBFO
UBND|UBND
UBOT|UBOT
UBP|UBP
UBP PRH|UBPpH
UBP PRK|UBPpK
UBR|UBR
UBS|UBS
UBSI|UBSI
UBT|UBT
UBX|UBX
UCBI|UCBI
UCBIO|UCBIO
UCC|UCC
UCIB|UCIB
UCL|UCL
UCO|UCO
UCON|UCON
UCRD|UCRD
UCTT|UCTT
UCYB|UCYB
UDEC|UDEC
UDI|UDI
UDIV|UDIV
UDMY|UDMY
UDN|UDN
UDOW|UDOW
UDR|UDR
UE|UE
UEC|UEC
UEIC|UEIC
UEVM|UEVM
UFAB|UFAB
UFCS|UFCS
UFEB|UFEB
UFI|UFI
UFO|UFO
UFPI|UFPI
UFPT|UFPT
UG|UG
UGA|UGA
UGE|UGE
UGI|UGI
UGIC|UGIC
UGL|UGL
UGP|UGP
UGRO|UGRO
UHAL|UHAL
UHALB|UHALB
UHS|UHS
UHT|UHT
UI|UI
UIHC|UIHC
UIS|UIS
UITB|UITB
UIVM|UIVM
UJAN|UJAN
UJB|UJB
UJUL|UJUL
UJUN|UJUN
UK|UK
UKOMW|UKOMW
UL|UL
ULBI|ULBI
ULCC|ULCC
ULE|ULE
ULH|ULH
ULST|ULST
ULTA|ULTA
ULTR|ULTR
ULVM|ULVM
UMAR|UMAR
UMAY|UMAY
UMBF|UMBF
UMC|UMC
UMDD|UMDD
UMH|UMH
UMH PRD|UMHpD
UMI|UMI
UMMA|UMMA
UMPQ|UMPQ
UNAM|UNAM
UNB|UNB
UNCY|UNCY
UNF|UNF
UNFI|UNFI
UNG|UNG
UNH|UNH
UNIT|UNIT
UNL|UNL
UNM|UNM
UNMA|UNMA
UNOV|UNOV
UNP|UNP
UNTY|UNTY
UNVR|UNVR
UOCT|UOCT
UONE|UONE
UONEK|UONEK
UP|UP
UP WS|UP.WS
UPAR|UPAR
UPC|UPC
UPH|UPH
UPH WS|UPH.WS
UPLD|UPLD
UPRO|UPRO
UPS|UPS
UPST|UPST
UPTD|UPTD
UPTDU|UPTDU
UPTDW|UPTDW
UPV|UPV
UPW|UPW
UPWD|UPWD
UPWK|UPWK
UPXI|UPXI
URA|URA
URBN|URBN
URE|URE
URG|URG
URGN|URGN
URI|URI
URNM|URNM
UROY|UROY
URTH|URTH
URTY|URTY
USA|USA
USAC|USAC
USAI|USAI
USAP|USAP
USAS|USAS
USAU|USAU
USB|USB
USB PRA|USBpA
USB PRH|USBpH
USB PRP|USBpP
USB PRQ|USBpQ
USB PRR|USBpR
USB PRS|USBpS
USBF|USBF
USCB|USCB
USCI|USCI
USCT|USCT
USCTU|USCTU
USCTW|USCTW
USD|USD
USDP|USDP
USDU|USDU
USEA|USEA
USEG|USEG
USEP|USEP
USEQ|USEQ
USER|USER
USFD|USFD
USFR|USFR
USHY|USHY
USI|USI
USIG|USIG
USIO|USIO
USL|USL
USLB|USLB
USLM|USLM
USM|USM
USMC|USMC
USMF|USMF
USML|USML
USMV|USMV
USNA|USNA
USNZ|USNZ
USO|USO
USOI|USOI
USPH|USPH
USPX|USPX
USRT|USRT
USSG|USSG
UST|UST
USTB|USTB
USVM|USVM
USVT|USVT
USX|USX
USXF|USXF
UTAA|UTAA
UTAAU|UTAAU
UTAAW|UTAAW
UTEN|UTEN
UTES|UTES
UTF|UTF
UTG|UTG
UTHR|UTHR
UTI|UTI
UTL|UTL
UTMD|UTMD
UTME|UTME
UTRN|UTRN
UTRS|UTRS
UTSI|UTSI
UTSL|UTSL
UTWO|UTWO
UTZ|UTZ
UUP|UUP
UUU|UUU
UUUU|UUUU
UVDV|UVDV
UVE|UVE
UVIX|UVIX
UVSP|UVSP
UVV|UVV
UVXY|UVXY
UWM|UWM
UWMC|UWMC
UWMC WS|UWMC.WS
UXI|UXI
UXIN|UXIN
UYG|UYG
UYLD|UYLD
UYM|UYM
UZD|UZD
UZE|UZE
UZF|UZF
V|V
VABK|VABK
VABS|VABS
VAC|VAC
VACC|VACC
VAL|VAL
VAL WS|VAL.WS
VALE|VALE
VALN|VALN
VALQ|VALQ
VALT|VALT
VALU|VALU
VAMO|VAMO
VANI|VANI
VAPO|VAPO
VAQC|VAQC
VATE|VATE
VAW|VAW
VAXX|VAXX
VB|VB
VBF|VBF
VBFC|VBFC
VBIV|VBIV
VBK|VBK
VBLT|VBLT
VBND|VBND
VBNK|VBNK
VBOC|VBOC
VBOCU|VBOCU
VBOCW|VBOCW
VBR|VBR
VBTX|VBTX
VC|VC
VCAR|VCAR
VCEB|VCEB
VCEL|VCEL
VCIF|VCIF
VCIT|VCIT
VCLN|VCLN
VCLO|VCLO
VCLT|VCLT
VCNX|VCNX
VCR|VCR
VCSA|VCSA
VCSH|VCSH
VCTR|VCTR
VCV|VCV
VCXA|VCXA
VCXAU|VCXAU
VCXAW|VCXAW
VCXB|VCXB
VCXB U|VCXB.U
VCXB WS|VCXB.WS
VCYT|VCYT
VDC|VDC
VDE|VDE
VDNI|VDNI
VEA|VEA
VECO|VECO
VECT|VECT
VEDU|VEDU
VEEE|VEEE
VEEV|VEEV
VEGA|VEGA
VEGI|VEGI
VEGN|VEGN
VEL|VEL
VELO|VELO
VELOU|VELOU
VELOW|VELOW
VENA|VENA
VENAR|VENAR
VENAU|VENAU
VENAW|VENAW
VEON|VEON
VERA|VERA
VERB|VERB
VERBW|VERBW
VERI|VERI
VERO|VERO
VERS|VERS
VERU|VERU
VERV|VERV
VERX|VERX
VERY|VERY
VET|VET
VEU|VEU
VEV|VEV
VFC|VFC
VFF|VFF
VFH|VFH
VFL|VFL
VFMF|VFMF
VFMO|VFMO
VFMV|VFMV
VFQY|VFQY
VFVA|VFVA
VGFC|VGFC
VGI|VGI
VGIT|VGIT
VGK|VGK
VGLT|VGLT
VGM|VGM
VGR|VGR
VGSH|VGSH
VGT|VGT
VGZ|VGZ
VHAQ|VHAQ
VHAQ RT|VHAQr
VHAQ U|VHAQ.U
VHAQ WS|VHAQ.WS
VHC|VHC
VHI|VHI
VHNA|VHNA
VHNAU|VHNAU
VHNAW|VHNAW
VHT|VHT
VIA|VIA
VIAO|VIAO
VIASP|VIASP
VIAV|VIAV
VICE|VICE
VICI|VICI
VICR|VICR
VIDI|VIDI
VIEW|VIEW
VIEWW|VIEWW
VIG|VIG
VIGI|VIGI
VIGL|VIGL
VII|VII
VIIAU|VIIAU
VIIAW|VIIAW
VINC|VINC
VINE|VINE
VINO|VINO
VINP|VINP
VIOG|VIOG
VIOO|VIOO
VIOT|VIOT
VIOV|VIOV
VIPS|VIPS
VIR|VIR
VIRC|VIRC
VIRI|VIRI
VIRS|VIRS
VIRT|VIRT
VIRX|VIRX
VIS|VIS
VISL|VISL
VIST|VIST
VITL|VITL
VIV|VIV
VIVE|VIVE
VIVK|VIVK
VIVO|VIVO
VIXM|VIXM
VIXY|VIXY
VJET|VJET
VKI|VKI
VKQ|VKQ
VKTX|VKTX
VLAT|VLAT
VLATU|VLATU
VLATW|VLATW
VLCN|VLCN
VLD|VLD
VLD WS|VLD.WS
VLDR|VLDR
VLDRW|VLDRW
VLGEA|VLGEA
VLN|VLN
VLN WS|VLN.WS
VLNS|VLNS
VLO|VLO
VLON|VLON
VLRS|VLRS
VLT|VLT
VLTA|VLTA
VLTA WS|VLTA.WS
VLU|VLU
VLUE|VLUE
VLY|VLY
VLYPO|VLYPO
VLYPP|VLYPP
VMAR|VMAR
VMAT|VMAT
VMBS|VMBS
VMC|VMC
VMCA|VMCA
VMCAU|VMCAU
VMCAW|VMCAW
VMD|VMD
VMEO|VMEO
VMGA|VMGA
VMGAU|VMGAU
VMGAW|VMGAW
VMI|VMI
VMO|VMO
VMOT|VMOT
VMW|VMW
VNAM|VNAM
VNCE|VNCE
VNDA|VNDA
VNET|VNET
VNLA|VNLA
VNM|VNM
VNMC|VNMC
VNO|VNO
VNO PRL|VNOpL
VNO PRM|VNOpM
VNO PRN|VNOpN
VNO PRO|VNOpO
VNOM|VNOM
VNQ|VNQ
VNQI|VNQI
VNRX|VNRX
VNSE|VNSE
VNT|VNT
VNTR|VNTR
VO|VO
VOC|VOC
VOD|VOD
VOE|VOE
VONE|VONE
VONG|VONG
VONV|VONV
VOO|VOO
VOOG|VOOG
VOOV|VOOV
VOR|VOR
VORB|VORB
VORBW|VORBW
VOT|VOT
VOTE|VOTE
VOX|VOX
VOXR|VOXR
VOXX|VOXX
VOYA|VOYA
VOYA PRB|VOYApB
VPC|VPC
VPCB|VPCB
VPCBU|VPCBU
VPCBW|VPCBW
VPG|VPG
VPL|VPL
VPN|VPN
VPU|VPU
VPV|VPV
VQS|VQS
VR|VR
VRA|VRA
VRAI|VRAI
VRAR|VRAR
VRAX|VRAX
VRAY|VRAY
VRCA|VRCA
VRDN|VRDN
VRE|VRE
VREX|VREX
VRIG|VRIG
VRM|VRM
VRME|VRME
VRMEW|VRMEW
VRNA|VRNA
VRNS|VRNS
VRNT|VRNT
VRP|VRP
VRPX|VRPX
VRRM|VRRM
VRSK|VRSK
VRSN|VRSN
VRT|VRT
VRTS|VRTS
VRTV|VRTV
VRTX|VRTX
VS|VS
VSAC|VSAC
VSACU|VSACU
VSACW|VSACW
VSAT|VSAT
VSCO|VSCO
VSDA|VSDA
VSEC|VSEC
VSGX|VSGX
VSH|VSH
VSLU|VSLU
VSMV|VSMV
VSS|VSS
VSSYW|VSSYW
VST|VST
VST WSA|VST.WS.A
VSTA|VSTA
VSTM|VSTM
VSTO|VSTO
VT|VT
VTC|VTC
VTEB|VTEB
VTEX|VTEX
VTGN|VTGN
VTHR|VTHR
VTI|VTI
VTIP|VTIP
VTIQ|VTIQ
VTIQU|VTIQU
VTIQW|VTIQW
VTN|VTN
VTNR|VTNR
VTOL|VTOL
VTR|VTR
VTRS|VTRS
VTRU|VTRU
VTSI|VTSI
VTV|VTV
VTVT|VTVT
VTWG|VTWG
VTWO|VTWO
VTWV|VTWV
VTYX|VTYX
VUG|VUG
VUSB|VUSB
VUSE|VUSE
VUZI|VUZI
VV|VV
VVI|VVI
VVNT|VVNT
VVOS|VVOS
VVPR|VVPR
VVR|VVR
VVV|VVV
VVX|VVX
VWE|VWE
VWEWW|VWEWW
VWID|VWID
VWO|VWO
VWOB|VWOB
VXF|VXF
VXRT|VXRT
VXUS|VXUS
VXX|VXX
VXZ|VXZ
VYGR|VYGR
VYM|VYM
VYMI|VYMI
VYNE|VYNE
VYNT|VYNT
VZ|VZ
VZIO|VZIO
VZLA|VZLA
W|W
WAB|WAB
WABC|WABC
WAFD|WAFD
WAFDP|WAFDP
WAFU|WAFU
WAL|WAL
WAL PRA|WALpA
WALD|WALD
WALDW|WALDW
WANT|WANT
WASH|WASH
WAT|WAT
WATT|WATT
WAVC|WAVC
WAVC U|WAVC.U
WAVC WS|WAVC.WS
WAVD|WAVD
WAVE|WAVE
WAVS|WAVS
WAVSU|WAVSU
WAVSW|WAVSW
WB|WB
WBA|WBA
WBAT|WBAT
WBD|WBD
WBEV|WBEV
WBIF|WBIF
WBIG|WBIG
WBIL|WBIL
WBIY|WBIY
WBND|WBND
WBS|WBS
WBS PRF|WBSpF
WBS PRG|WBSpG
WBX|WBX
WBX WS|WBX.WS
WCBR|WCBR
WCC|WCC
WCC PRA|WCCpA
WCLD|WCLD
WCN|WCN
WD|WD
WDAY|WDAY
WDC|WDC
WDFC|WDFC
WDH|WDH
WDI|WDI
WDIV|WDIV
WDNA|WDNA
WDS|WDS
WE|WE
WE WS|WE.WS
WEA|WEA
WEAT|WEAT
WEAV|WEAV
WEBL|WEBL
WEBR|WEBR
WEBS|WEBS
WEC|WEC
WEED|WEED
WEIX|WEIX
WEJO|WEJO
WEJOW|WEJOW
WEL|WEL
WEL U|WEL.U
WEL WS|WEL.WS
WELL|WELL
WEN|WEN
WERN|WERN
WES|WES
WEST|WEST
WESTW|WESTW
WETG|WETG
WEX|WEX
WEYS|WEYS
WF|WF
WFC|WFC
WFC PRA|WFCpA
WFC PRC|WFCpC
WFC PRD|WFCpD
WFC PRL|WFCpL
WFC PRQ|WFCpQ
WFC PRR|WFCpR
WFC PRY|WFCpY
WFC PRZ|WFCpZ
WFCF|WFCF
WFG|WFG
WFH|WFH
WFHY|WFHY
WFIG|WFIG
WFRD|WFRD
WGMI|WGMI
WGO|WGO
WGRO|WGRO
WH|WH
WHD|WHD
WHF|WHF
WHG|WHG
WHLM|WHLM
WHLR|WHLR
WHLRD|WHLRD
WHLRL|WHLRL
WHLRP|WHLRP
WHR|WHR
WIA|WIA
WIL|WIL
WILC|WILC
WIMI|WIMI
WINA|WINA
WINC|WINC
WING|WING
WINN|WINN
WINT|WINT
WINV|WINV
WINVR|WINVR
WINVU|WINVU
WINVW|WINVW
WIP|WIP
WIRE|WIRE
WISA|WISA
WISH|WISH
WIT|WIT
WIW|WIW
WIX|WIX
WIZ|WIZ
WK|WK
WKEY|WKEY
WKHS|WKHS
WKLY|WKLY
WKME|WKME
WKSP|WKSP
WKSPW|WKSPW
WLDN|WLDN
WLDR|WLDR
WLDS|WLDS
WLDSW|WLDSW
WLFC|WLFC
WLK|WLK
WLKP|WLKP
WLMS|WLMS
WLTG|WLTG
WLTH|WLTH
WLY|WLY
WLYB|WLYB
WM|WM
WMB|WMB
WMC|WMC
WMG|WMG
WMK|WMK
WMPN|WMPN
WMS|WMS
WMT|WMT
WNC|WNC
WNDY|WNDY
WNEB|WNEB
WNNR|WNNR
WNNR U|WNNR.U
WNNR WS|WNNR.WS
WNS|WNS
WNW|WNW
WOLF|WOLF
WOMN|WOMN
WOOD|WOOD
WOOF|WOOF
WOR|WOR
WORX|WORX
WOW|WOW
WPC|WPC
WPCA|WPCA
WPCA U|WPCA.U
WPCB|WPCB
WPCB U|WPCB.U
WPM|WPM
WPP|WPP
WPRT|WPRT
WPS|WPS
WQGA|WQGA
WQGA U|WQGA.U
WQGA WS|WQGA.WS
WRAC|WRAC
WRAC U|WRAC.U
WRAC WS|WRAC.WS
WRAP|WRAP
WRB|WRB
WRB PRE|WRBpE
WRB PRF|WRBpF
WRB PRG|WRBpG
WRB PRH|WRBpH
WRBY|WRBY
WRK|WRK
WRLD|WRLD
WRN|WRN
WRND|WRND
WSBC|WSBC
WSBCP|WSBCP
WSBF|WSBF
WSC|WSC
WSFS|WSFS
WSM|WSM
WSO|WSO
WSO B|WSO.B
WSR|WSR
WST|WST
WT|WT
WTAI|WTAI
WTBA|WTBA
WTER|WTER
WTFC|WTFC
WTFCM|WTFCM
WTFCP|WTFCP
WTI|WTI
WTM|WTM
WTMA|WTMA
WTMAR|WTMAR
WTMAU|WTMAU
WTMF|WTMF
WTRE|WTRE
WTRG|WTRG
WTS|WTS
WTT|WTT
WTTR|WTTR
WTV|WTV
WTW|WTW
WU|WU
WUGI|WUGI
WULF|WULF
WVE|WVE
WVVI|WVVI
WVVIP|WVVIP
WW|WW
WWAC|WWAC
WWACU|WWACU
WWACW|WWACW
WWD|WWD
WWE|WWE
WWJD|WWJD
WWR|WWR
WWW|WWW
WY|WY
WYNN|WYNN
WYY|WYY
X|X
XAIR|XAIR
XAR|XAR
XB|XB
XBAP|XBAP
XBB|XBB
XBI|XBI
XBIO|XBIO
XBIOW|XBIOW
XBIT|XBIT
XBJA|XBJA
XBJL|XBJL
XBOC|XBOC
XBTF|XBTF
XC|XC
XCCC|XCCC
XCEM|XCEM
XCLR|XCLR
XCOR|XCOR
XCUR|XCUR
XDAP|XDAP
XDAT|XDAT
XDEC|XDEC
XDJA|XDJA
XDJL|XDJL
XDNA|XDNA
XDOC|XDOC
XDQQ|XDQQ
XDSQ|XDSQ
XEL|XEL
XELA|XELA
XELAP|XELAP
XELB|XELB
XEMD|XEMD
XENE|XENE
XERS|XERS
XES|XES
XFIN|XFIN
XFINU|XFINU
XFINW|XFINW
XFIV|XFIV
XFLT|XFLT
XFLT PRA|XFLTpA
XFOR|XFOR
XGN|XGN
XHB|XHB
XHE|XHE
XHLF|XHLF
XHR|XHR
XHS|XHS
XHYC|XHYC
XHYD|XHYD
XHYE|XHYE
XHYF|XHYF
XHYH|XHYH
XHYI|XHYI
XHYT|XHYT
XIN|XIN
XITK|XITK
XJH|XJH
XJR|XJR
XJUN|XJUN
XLB|XLB
XLC|XLC
XLE|XLE
XLF|XLF
XLG|XLG
XLI|XLI
XLK|XLK
XLO|XLO
XLP|XLP
XLRE|XLRE
XLSR|XLSR
XLU|XLU
XLV|XLV
XLY|XLY
XM|XM
XME|XME
XMHQ|XMHQ
XMLV|XMLV
XMMO|XMMO
XMPT|XMPT
XMTR|XMTR
XMVM|XMVM
XNAV|XNAV
XNCR|XNCR
XNET|XNET
XNTK|XNTK
XOM|XOM
XOMA|XOMA
XOMAO|XOMAO
XOMAP|XOMAP
XONE|XONE
XOP|XOP
XOS|XOS
XOSWW|XOSWW
XOUT|XOUT
XP|XP
XPAX|XPAX
XPAXU|XPAXU
XPAXW|XPAXW
XPDB|XPDB
XPDBU|XPDBU
XPDBW|XPDBW
XPEL|XPEL
XPER|XPER
XPEV|XPEV
XPH|XPH
XPL|XPL
XPND|XPND
XPO|XPO
XPOF|XPOF
XPON|XPON
XPP|XPP
XPRO|XPRO
XRAY|XRAY
XRLV|XRLV
XRMI|XRMI
XRT|XRT
XRTX|XRTX
XRX|XRX
XSD|XSD
XSEP|XSEP
XSHD|XSHD
XSHQ|XSHQ
XSLV|XSLV
XSMO|XSMO
XSOE|XSOE
XSVM|XSVM
XSVN|XSVN
XSW|XSW
XT|XT
XTAP|XTAP
XTEN|XTEN
XTJA|XTJA
XTJL|XTJL
XTL|XTL
XTLB|XTLB
XTN|XTN
XTNT|XTNT
XTOC|XTOC
XTR|XTR
XTRE|XTRE
XTWO|XTWO
XTWY|XTWY
XUSP|XUSP
XVOL|XVOL
XVV|XVV
XWEB|XWEB
XWEL|XWEL
XXII|XXII
XYF|XYF
XYL|XYL
XYLD|XYLD
XYLG|XYLG
YALA|YALA
YALL|YALL
YANG|YANG
YCBD|YCBD
YCBD PRA|YCBDpA
YCL|YCL
YCS|YCS
YDEC|YDEC
YEAR|YEAR
YELL|YELL
YELP|YELP
YETI|YETI
YEXT|YEXT
YGMZ|YGMZ
YI|YI
YINN|YINN
YJ|YJ
YJUN|YJUN
YLD|YLD
YLDE|YLDE
YMAB|YMAB
YMAR|YMAR
YMM|YMM
YMTX|YMTX
YNDX|YNDX
YOLO|YOLO
YORW|YORW
YOSH|YOSH
YOTA|YOTA
YOTAR|YOTAR
YOTAU|YOTAU
YOTAW|YOTAW
YOU|YOU
YPF|YPF
YPS|YPS
YQ|YQ
YRD|YRD
YSEP|YSEP
YSG|YSG
YTEN|YTEN
YTPG|YTPG
YTRA|YTRA
YUM|YUM
YUMC|YUMC
YUMY|YUMY
YVR|YVR
YXI|YXI
YY|YY
YYY|YYY
Z|Z
ZAZZT|ZAZZT
ZBH|ZBH
ZBRA|ZBRA
ZBZX|ZBZX
ZBZZT|ZBZZT
ZCMD|ZCMD
ZCZZT|ZCZZT
ZD|ZD
ZDGE|ZDGE
ZECP|ZECP
ZENV|ZENV
ZEPP|ZEPP
ZEST|ZEST
ZETA|ZETA
ZEUS|ZEUS
ZEV|ZEV
ZEV WS|ZEV.WS
ZEXIT|ZEXIT
ZFOX|ZFOX
ZFOXW|ZFOXW
ZG|ZG
ZGEN|ZGEN
ZGN|ZGN
ZGN WS|ZGN.WS
ZH|ZH
ZHDG|ZHDG
ZI|ZI
ZIEXT|ZIEXT
ZIG|ZIG
ZIM|ZIM
ZIMV|ZIMV
ZING|ZING
ZINGU|ZINGU
ZINGW|ZINGW
ZION|ZION
ZIONL|ZIONL
ZIONO|ZIONO
ZIONP|ZIONP
ZIP|ZIP
ZIVO|ZIVO
ZIVOW|ZIVOW
ZJZZT|ZJZZT
ZKIN|ZKIN
ZLAB|ZLAB
ZM|ZM
ZNH|ZNH
ZNTL|ZNTL
ZOM|ZOM
ZROZ|ZROZ
ZS|ZS
ZSL|ZSL
ZT|ZT
ZTAQU|ZTAQU
ZTAQW|ZTAQW
ZTEK|ZTEK
ZTEST|ZTEST
ZTO|ZTO
ZTR|ZTR
ZTS|ZTS
ZUMZ|ZUMZ
ZUO|ZUO
ZVIA|ZVIA
ZVV|ZVV
ZVZZC|ZVZZC
ZVZZT|ZVZZT
ZWRK|ZWRK
ZWRKU|ZWRKU
ZWRKW|ZWRKW
ZWS|ZWS
ZWZZT|ZWZZT
ZXIET|ZXIET
ZXZZT|ZXZZT
ZYME|ZYME
ZYNE|ZYNE
ZYXI|ZYXI
ZZK|ZZK
ZZZ|ZZZ